康爱保赠送的高发肿瘤基因检测或良性肿瘤检测有没限制谁	询问增值服务内容
有单位的公费医疗按有社保人士投保还是非社保人士投保	other
重疾绿医通道登记被保险人但给其他人使用，你们有监管措施	询问增值服务内容
线上和线下投保优惠有什么不同，你们和网点一样有	购买某项保险产品有无优惠
国内重大疾病绿色就医通道，是不是客户罹患轻症就可以使用的	询问增值服务内容
重疾绿医通道只有患重疾才可以使用吗？	询问增值服务内容
此前有过被延期承保的算次标准体	other
赔付完毕后，合同会终止吗	询问合同终止
有特别说明和约定的情况吗	询问特别约定
重疾绿医通道有在居住地有fwxm吗？	询问增值服务内容
晚上问问题有时间限制吗	咨询时间
拨打寰宇卡救援号码要不要收费？	询问增值服务内容
康爱保是否存在健康及职业加费情况？	other
门(急)诊医疗	释义项的定义
在线问诊或健康测评的操作？	询问增值服务内容
康爱保的特色？/亮点？	询问产品优势
附加险能否到保险机构附加？	询问附加险
投保后有对应的售后服务吗	服务内容介绍
重疾绿医通道患轻症可以使用吗	询问增值服务内容
办理业务都需要提供保单原件吗	业务办理提交材料
官方微信中专业fwxm服务时间是什么	询问增值服务内容
续保有等待期吗	询问等待期
治疗费用严重ⅲ度烧伤	疾病治疗费用
赔过重疾过后，酒后开车还能赔吗	某情景是否在承保范围内
可以电话联系我么	other
海外就医安排服务是什么服务	询问增值服务内容
国内放射科排名第一的医院	询问合作医院
国内妇产科排名第一的医院	询问合作医院
国内麻醉科排名第一的医院	询问合作医院
生命特别保险金和生命特别保险金共用保额吗	询问保额
b超检查项目有哪些？	某项体检的包含项
国内胸外科排名第一的医院	询问合作医院
什么情况下信托合同自动终止	合同自动终止的情景
康爱保非年缴保费的折算系数是什么？	保费核算
手机可以投保吗	投保途径
康爱保的健康核保规则	投保指引
国内老年医学排名第一的医院	询问合作医院
国内普通外科排名第一的医院	询问合作医院
最高能买多少	产品保额限制
疾病末期开证明	other
康爱保的保障期是？	产品保障期限
康爱保的保险责任？	询问保险责任
月缴能改成年缴吗	询问变更缴费方式
变更保险合同需要提供什么资料	询问合同变更
康爱保和康爱保有什么区别	保险产品对比
附加康爱保提前给付特定bxzl提供哪些保障？	询问保险责任
犹豫期保费退保率	询问犹豫期
康爱保的附加规则	投保指引
这个保险保什么	询问保险责任
关于住院的要求	释义项的定义
补充告知的规定	询问如实告知
更改个人身份资料的规定	询问合同变更
等待期内有大病可以投保吗	某种情景是否可以投保 询问等待期
中信保诚改名了？	询问公司介绍
可以为自己兄弟姐妹投保吗	投保人和被保险人关系
在线问诊健康评测内容	询问增值服务内容
康爱保变更合同？	询问合同变更
康爱保投保规则？	询问投保规则
线上和线下投保优惠区别	购买某项保险产品有无优惠
开门红期间重大疾病绿色就医通道	询问增值服务内容
保费测算	保费核算
医院要求	理赔医院
免赔额多少	询问免赔额数值
康爱保良性肿瘤？	疾病的定义
续期缴费规则	询问缴费方式
浙江合作医院	询问合作医院
内蒙合作医院	询问合作医院
贵州合作医院	询问合作医院
西藏合作医院	询问合作医院
广西合作医院	询问合作医院
良性肿瘤检测的供应商	询问增值服务内容
电话医生使用期限	询问增值服务内容
险种关联选择申请资料	险种关联选择申请资料
轻症和重疾的标准是什么	区分疾病种类的标准
重疾体检中一般体检包含什么	询问体检或验尸
保障年限	询问保险期间
减额缴清	询问减额缴清
免赔额	询问免赔额定义
纸质合同	申请纸质合同
办理保单回溯	保单回溯
康爱保保额限制	产品保额限制
被保险人年龄范围	询问投保年龄
什么是重大疾病	疾病种类的定义
康爱保酒后开车、酒后开车？	释义项的定义
国外理赔	理赔的地域限制
sy	释义项的定义
检测机构	询问增值服务内容
康爱保优势	询问产品优势
增值服务	询问增值服务项目
酒后开车赔付吗	某情景是否在承保范围内
复效期滞纳金	复效期有无收取滞纳金
康爱保重疾	疾病种类的定义
康爱保已缴费年期数？	询问缴费年期
生命特别保险金理赔资料	保障项目的理赔方式
客服热线	询问联系方式
关于癌症靶向疗法	释义项的定义
良性肿瘤投保	患某疾病是否可以投保
湖北分公司联系方式	询问分公司联系方式
河北分公司联系方式	询问分公司联系方式
天津分公司联系方式	询问分公司联系方式
给付型保险	保险类型判断
中信银行手机投保流程	某渠道的投保流程
insuranceagent	other
乳腺基因检测的意义	询问增值服务内容
轻症赔付	疾病种类的赔付流程
轻症种类	疾病种类的定义
bxzl的生存期	询问疾病种类的生存期
良性肿瘤保不保	患某疾病是否可以投保 某种疾病是否在承保范围内
如何申领康爱保生命特别保险金？	保障项目如何申请理赔
康爱保升级能附加住院bxzl吗	询问附加险 产品升级介绍
康爱保的保险责任是什么	询问保险责任
康爱保有多少天的犹豫期呢	询问犹豫期
康爱保最低保额	某产品的最低保额
生命特别保险金的免赔天数是多少	other
康爱保的保障期	产品保障期限
康爱保身体检查与验尸	询问体检或验尸
康爱保的未归还款项及利息的偿还	询问未归还款项偿还
生命特别保险金和生命特别保险金共用保额吗	询问保额
康爱保增值服务	询问增值服务项目
你好啊	other
保单借款	询问保单借款
1月1日至3月31日这期间购买，是针对	询问增值服务项目
说好了是送电话医生，怎么是给我卖保险	询问增值服务内容
理赔了生命特别保险金后，有幸活过6个月，那后期怎么办？	other
有社保和没社保的价格会有不同吗	保费核算
寰宇卡服务里的增值礼遇的绿色服务通道是什么？	询问增值服务内容
5年内复发，由于之前的病引起的其他病可以使用	询问增值服务内容
海外就医安排服务，提供5次，每次8小时的就医	询问增值服务内容
康复随诊关怀里面说到并监督、督促客户，是如何	询问增值服务内容
合同中止了，在缴费有等待期吗	询问等待期
电话医生现在怎么获得跟之前是一样的吗？	询问增值服务内容
尊享会员年化保费达到10-50万享受三甲医院绿医通道	询问增值服务内容
附加险的费用是一年一年交的吗？	某类险种的缴费方式
入住重症监护室后，除了床位费，其他的器械治疗费用能包吗	疾病种类治疗费用
开门红期间享受的重大疾病绿色就医通道服务跟之前的有冲突	询问增值服务内容
异地就医补贴，最高省内2省外5000就医补贴，这个补贴	询问增值服务内容
客户购买的保费达到白金卡级别，可以跳过享受国内疾病重疾	询问增值服务内容
那一万是绝对免赔额还是相对免赔额	询问保险条款
治疗良性肿瘤可以算在良性肿瘤治疗生命特别保险金当中吗？	询问保险条款
康爱保赠送的信享卡增值服务需要客户激活吗？	询问增值服务项目
康爱保可以单独附加amr（信诚附加意外伤害医疗保险）吗？	询问附加险
团（个）险保费占比	释义项的定义
在线问诊是有限定时间使用的吗？	询问增值服务内容
理赔后的收据和发票还能取回吗	保障项目的理赔方式
赔付过重疾最后终老还可以赔付吗？	保障项目的理赔方式
银保通出单康爱保，对客户职业有限制吗？	投保的职业要求
良性肿瘤基因检测样品快递费用是客户到付吗？	询问保险条款
保单搭配有其他附加险，在理赔“生命特别保险金”后，	询问附加险 忘记交保费的解决办法
你们的专业术语我都不太懂	咨询引导
长(短)期险保费占比	释义项的定义
康爱保保单生效后，可以更改缴费方式吗？	询问变更缴费方式
办理终止续期保费自动转账后能重新授权银行账户扣费吗	询问保险费缴纳
生命特别保险金给了一半后，保费还需要缴吗？	保障项目给付一半后的处理方法
康爱保“生命特别保险金”里涉及的“严重疾病”是否必须为	询问保险条款
比例（非比例）保费占比	释义项的定义
办理终止续期保费自动转账后仍会自动划扣保费吗	询问保险费缴纳
对被保人的职业有要求吗	投保的职业要求
手机上投保有纸质合同吗？	申请纸质合同
寰宇卡金卡尊贵型和银卡基础型的区别？	询问增值服务项目
保单借款必须在6个月内归还本息吗？	保单借款的还款期限
关于轻症重疾确诊就赔吗？	疾病种类的定义
高发良性肿瘤基因检测是去哪里检测？	询问增值服务内容
重疾的预约挂号费需要客户出吗？	询问增值服务内容
申请医疗费用和津贴理赔要递交的资料	保障项目如何申请理赔
尊尚会员年化保费达到5-10万享受重大疾病绿色就医通道	询问增值服务内容
临分（合同）保费占比	释义项的定义
重子质离子治疗能报销吗	产品费用与报销
你们公司经营和偿付水平不错吧	公司经营状况
你们的检测机构有权威吗？	询问增值服务内容
重疾绿医通道服务谁能用？	询问增值服务内容
理赔审核中可以先退还病历资料吗	保障项目的理赔方式
职业等级5级以上能否投保康爱保？	投保的职业要求
日常生活中如何更好的预防良性肿瘤的发生	某种疾病的预防
长(短)期险保费增长率	释义项的定义
在线问诊是全天24小时的吗	询问增值服务内容
境外体检（尊享版）服务内容	询问增值服务内容
年交保费和年收入之间的合理比例	询问缴费年期
投保康爱保，可以附加什么险种？	询问附加险
购买过其他保险，有冲突吗	保险是否有购买限制
诊断证明病理报告会很难拿吗？	诊断报告的领取
电话医生是投保人使用还是被保人使用	询问增值服务内容
保单生效后，能否中途取消康爱保提前给付特定bxzl？	询问合同解除
中途新增附加康爱保提前给付特定bxzl时有什么要满足什么条件	询问保险金给付
客户申领生命特别保险金时，除了常规理赔资料外，还需提供	保障项目如何申请理赔
免赔额是共用的吗	询问保险条款
有社保会有冲突吗？	保险是否有购买限制
康爱保的犹豫期是多少天？	询问犹豫期
门诊的报销有要求吗	询问保险条款
电话医生可以给家人用吗	询问增值服务内容
国内超声医学排名第一的医院	询问合作医院
国内检验医学排名第一的医院	询问合作医院
国内小儿外科排名第一的医院	询问合作医院
国内急诊医学排名第一的医院	询问合作医院
国内神经医学排名第一的医院	询问合作医院
国内临床药学排名第一的医院	询问合作医院
国内小儿内科排名第一的医院	询问合作医院
电话医生的使用时间是？	询问增值服务内容
国内康复医学排名第一的医院	询问合作医院
康爱保“银保通”出单特别规定	投保指引
小孩不足1周岁患病怎么赔付？	特殊人群的理赔方式
电话医生服务的电话号码是多少？	询问增值服务内容
治疗费用良性肿瘤（冠状动脉旁路移植术）	疾病治疗费用
理赔“生命特别保险金”后，客户缓缴的余下各期保费将	忘记交保费的解决办法 理赔后缓缴保险费的处理办法
住院可以报销的吗	询问保险条款
国内二诊意见是什么服务	询问增值服务内容
合同到期后还有保障吗	产品保障期限
宽限期过后会有滞纳金吗	询问增值服务内容
重疾绿医通道具体怎样的？	询问增值服务内容
绿医通道需要付挂号费吗？	询问增值服务内容
寰宇卡客户层级及定级标准	询问增值服务内容
为什么已投保暖宝保就不能再投康爱保	投保人和被保险人关系
用多少钱买	保费支出
年交和月交区别	询问缴费年期
公司会倒闭吗？	公司经营状况
去国外能赔吗	国外医院的要求
常见的疾病有哪些	疾病包含哪些疾病
为什么选50万保额	推荐保额
国内眼科排名第一的医院	询问合作医院
康爱保能否保单垫缴？	询问保费垫缴
特殊职业方面有要求吗	投保的职业要求
国内骨科排名第一的医院	询问合作医院
申请保单贷款需要利息吗	询问保单借款
原（分）保费收入增长率	释义项的定义
康爱保可以升级为康爱保吗？	产品升级介绍
信诚附加轻症豁免保险费bxzl的保障期？	产品保障期限
申请保单借款后还能申请减额缴清吗？	询问保单借款 询问减额缴清
良性肿瘤或高发肿瘤基因检测在等待期查出会不会拒保？	患某疾病是否可以投保
你是客服吗	other
康爱保的复效期？	询问复效期
可以附加其他险种吗	询问附加险
终身是99岁吗	险种的年龄限制
康爱保的等待期？	询问等待期
国内心外科排名第一的医院	询问合作医院
国内核医学排名第一的医院	询问合作医院
国内内分泌排名第一的医院	询问合作医院
国内烧伤科排名第一的医院	询问合作医院
国内传染科排名第一的医院	询问合作医院
康爱保的犹豫期怎么计算？	询问犹豫期
重疾绿医通道能用几次	询问增值服务内容
国内病理科排名第一的医院	询问合作医院
国内口腔科排名第一的医院	询问合作医院
近半年的体检结果能用吗	体检的时限要求
国内肾脏病排名第一的医院	询问合作医院
康爱保可以减额缴清吗？	询问减额缴清
血液检查项目有哪些？	某项体检的包含项
国内呼吸科排名第一的医院	询问合作医院
国内皮肤科排名第一的医院	询问合作医院
国内风湿科排名第一的医院	询问合作医院
国内肿瘤学排名第一的医院	询问合作医院
原（分）保费收入市场份额	释义项的定义
什么人可以作为投保人？	投保人条件限制
康爱保可以变更缴费方式吗？	询问变更缴费方式
可以申请终止续期保费自动转账吗	询问保险费缴纳
信诚附加轻症豁免保险费bxzl的附加规则？	询问附加险
保单同时附加了附加轻症豁免保险费bxzl和投保人豁免c款。	询问附加险
什么叫良性肿瘤？	疾病的定义
交一千可以吗	other
与银行的关系	other
国外有没有中信银行呢？	中信银行
豁免保费后保单借款	询问保单借款
康爱保得过什么奖项	询问产品优势
康爱保的缴费期？	询问缴费年期
指定第二投保人的规则	询问投保人
康爱保的职业核保规则	投保指引
有良性肿瘤可以投保吗；	患某疾病是否可以投保
国内神经外科排名第一的医院	询问合作医院
国内泌尿外科排名第一的医院	询问合作医院
国内神经内科排名第一的医院	询问合作医院
国内耳鼻喉科排名第一的医院	询问合作医院
康复随诊关怀是什么服务	询问增值服务内容
专业导医陪诊是什么服务	询问增值服务内容
异地就医补贴是什么服务	询问增值服务内容
国内整形外科排名第一的医院	询问合作医院
住院治疗费用是包括了哪些？	释义项的定义
国内心血管病排名第一的医院	询问合作医院
60周岁以上能作为投保人吗？	保障项目的年龄限制
买尊享能享受个税优惠吗	购买某项保险产品有无优惠
康爱保赠送的增值服务使用时间次数？	询问增值服务项目
保单生效后，中途可以申请降低附加康爱保提前给付特定bxzl	询问保险金给付
保单搭配有附加轻症豁免保险费bxzl和其它附加险，如	询问附加险
能自动续保吗	询问保险条款
死差损（益）	释义项的定义
全国定点理赔医院	理赔医院
费差损（益）	释义项的定义
利差损（益）	释义项的定义
理赔需要发票吗	询问保险条款
等待期/观察期	询问等待期
康爱保的保额累计？	询问保额累计
康爱保的最高保额？	产品保额限制
康爱保争议的处理？	询问争议处理
减额交清有什么影响	减额缴清的影响
康爱保的缴费方式？	询问缴费方式
康爱保的投保年龄？	询问投保年龄
在线问诊要收费吗	询问增值服务内容
投保可以不健康告知吗	询问如实告知
能否附加意外医疗保险？	询问附加险
康爱保的保额规定？	询问保额规定
康爱保附加险变更规则	询问附加险
高发肿瘤基因检测的供应商	询问增值服务内容
康爱保可以变更保险金额吗？	询问合同变更
之前酒后开车还可以参加吗	某种情景是否可以投保
全名无忧可选保额吗	询问保额规定
在国外可以使用中信银行app吗？	中信银行
已经买过住院bxzl能否再投保康爱保	保险是否有购买限制
国内重症医学排名第一的医院？	询问合作医院
康爱保的酒后开车免责条款（除外责任）？	保障项目的责任免除详情
那酒后开车呢	情景的定义
有红利吗	红利申请规定
你们公司地址在哪里	公司地址
诉讼时限及要求	询问诉讼时效
康爱保的复效期	询问复效期
中途缴费停了	询问宽限期时间
同一次事故住院	询问保险条款
康爱保的保全规则	投保指引
变更投保人的规定	变更投保人
良性肿瘤的发病原因	疾病发病原因
全残的免责条款	询问保险条款
红利领取的规定	红利申请规定
康爱保的财务规则	投保指引
康爱保的等待期	询问等待期
早产儿可以购买吗？	特殊人群投保规则
康爱保的保额累计规则	询问保额累计
康爱保能否减额交清？	询问减额缴清
康爱保投保书填写？	询问投保书填写
康爱保能否保单借款？	询问保单借款
可以帮父母买吗	投保人和被保险人关系
寰宇卡绿色服务通道	询问增值服务内容
康爱保投保有地域限制吗	产品保障的地域限制
康爱保增值服务赠送要求？	询问增值服务项目
乳腺体检异常指标是什么	某种体检异常指标定义
快速检查fwxm是什么服务	询问增值服务内容
专家手术fwxm是什么服务	询问增值服务内容
专家住院fwxm是什么服务	询问增值服务内容
未成年人父母双亡可以买康爱保吗？	特殊人群投保规则
康爱保升级能附加住院bxzl吗？	询问附加险 产品升级介绍
达到体检保额	体检指引
地震、天灾	询问情景的定义
客服中心地址	公司地址
什么时候回复	咨询时间
怎么申请保单借款	询问保单借款
标准保费（寿险）	释义项的定义
孕妇可以投保吗	投保人条件限制
理赔报案的目的	理赔报案的目的
康爱保的缴费期	询问缴费年期
寰宇卡金卡与银卡区别	询问增值服务项目
核保不通过怎么办？	核保不通过解决办法
直接赔付率（简单赔付率）	释义项的定义
1型良性肿瘤患者投保	患某疾病是否可以投保
赔了重症可以赔轻疾吗？	不同保障项目的重复理赔
趸交	释义项的定义 询问缴费年期 
附加住院医疗	询问附加险
不可争条款	询问保险条款
云助理电话	询问联系方式
查当地公司	询问公司介绍
保证续保吗	询问保险条款
买保险要求	询问投保规则
康爱保是什么	产品介绍
等待期是多长	询问等待期
可以保单回溯吗	保单回溯
无受益人分配	询问受益人
康爱保的缴费方式	询问缴费方式
寰宇卡救援电话	询问增值服务内容
康爱保的投保年龄	询问投保年龄
康爱保其他规则？	询问投保规则
康爱保的保险责任	询问保险责任
现金分红(保费分红）	释义项的定义
附加轻症豁免时间	疾病种类的定义
基因检测怎么做	询问增值服务内容
甲状腺癌是重疾吗	疾病种类的定义
康爱保的投保规则	询问投保规则
合同去哪里领取	询问合同领取方式
信享卡服务介绍	询问增值服务内容
垄断竞争型保险市场	保险类型判断
康爱保的保险期间	产品保障期限
康爱保的产品优势	询问产品优势
康爱保的最高保额	产品保额限制
身体健康有什么定义	释义项的定义
分公司（二级机构）	释义项的定义
寰宇卡服务内容	询问增值服务内容
已付赔款赔付率（业务年度）	释义项的定义
免责内容有哪几项	保障项目的责任免除详情
康爱保未成年人保额累计？	询问保额累计
康爱保身体检查与验尸？	询问体检或验尸
附加价值服务卡能否补发	询问增值服务内容
重疾fwxm的开通时间	询问增值服务内容
酒后开车可以赔付吗？	某情景是否在承保范围内
康爱保变更缴费方式？	询问变更缴费方式
重疾fwxm的使用时间	询问增值服务内容
产品利率及投连价格查询	投资连结保险投资账户介绍
如何缴费	投保指引
辛苦了	other
保单真假	保单查询
合同丢失	合同丢失
附加险	询问附加险
复效期	询问复效期
垫缴	询问保费垫缴
在干嘛	other
体检报告	体检指引
增加保额	询问保额
体检规则	体检指引
体检费用	体检指引
多少钱	other
如何投保	投保指引
高发疾病	高发疾病
理赔速度	理赔速度
理赔条件	理赔条件
等待期	询问等待期
保险用处	产品介绍
理赔合作医院	询问合作医院
乳房的构成	身体器官的构成
公司官网地址	询问公司介绍
有多少分公司	询问公司介绍
可购最高限额	产品保额限制
酒后开车免责条款	询问保险条款
红利领取方式	红利申请规定
微信咨询服务时间	咨询时间
最高可购限额	产品保额限制
可以指定受益人	询问受益人
重庆合作医院	询问合作医院
江西合作医院	询问合作医院
宁夏合作医院	询问合作医院
山西合作医院	询问合作医院
治疗费用良性肿瘤	疾病治疗费用
海南合作医院	询问合作医院
上海合作医院	询问合作医院
安徽合作医院	询问合作医院
甘肃合作医院	询问合作医院
康爱保平安终老	产品介绍
江苏合作医院	询问合作医院
广东合作医院	询问合作医院
山东合作医院	询问合作医院
青海合作医院	询问合作医院
四川合作医院	询问合作医院
湖南合作医院	询问合作医院
吉林合作医院	询问合作医院
辽宁合作医院	询问合作医院
云南合作医院	询问合作医院
河北合作医院	询问合作医院
港澳台手机购买	某渠道的投保流程
福建合作医院	询问合作医院
湖北合作医院	询问合作医院
天津合作医院	询问合作医院
新疆合作医院	询问合作医院
陕西合作医院	询问合作医院
河南合作医院	询问合作医院
北京合作医院	询问合作医院
康爱保的bxj？	保障项目的定义
可以重复赔付吗	保障项目的赔付次数
康爱保属于什么险种	询问保险种类
基因检测快递费用	询问增值服务内容
电话医生服务介绍	询问增值服务内容
人均保费（人均产能）	释义项的定义
酒后开车能不能保	某种情景是否可以投保
电话医生保费要求	询问增值服务内容
康爱保的宽限期？	询问宽限期时间
康爱保的现金价值？	询问现金价值
电话医生使用流程	询问增值服务内容
康爱保投保年龄要求	询问投保年龄
电话医生使用次数	询问增值服务内容
重疾绿医通道标准	询问增值服务内容
基因检测使用时间	询问增值服务内容
缴费方式中途更换	询问变更缴费方式
康爱保理赔快吗？	理赔速度
高危人群	释义项的定义
良性肿瘤定义	疾病的定义
退保率	释义项的定义
理赔案例	other
返本时间	other
考虑因素	other
合伙骗人	other
转机器人	other
良性肿瘤定义	疾病的定义
康爱保体检标准？	体检标准
康爱保保什么	询问保险责任
康爱保的犹豫期	询问犹豫期
保险责任准备金	询问保险责任
附加意外医疗保险	询问附加险
医学必要的定义	释义项的定义
重疾赔付次数	疾病种类的定义
国外医院要求	国外医院的要求
老人投保体检	询问体检或验尸
黑龙江合作医院	询问合作医院
康爱保附加险种	询问附加险
乳腺异常高发区域	某种疾病的高发区域
康爱保解除保险合同？	询问合同解除
康爱保增值服务？	询问增值服务项目
酒后开车可以投保吗	某种情景是否可以投保
康爱保的生命特别保险金？	保障项目的定义
手机投保月缴首期	投保渠道的月缴首期
康爱保的最低保额	某产品的最低保额
fwxm给其他人用	询问增值服务内容
轻症重疾定义	疾病种类的定义
酒后开车全残给付	询问保险金给付
海外二次诊疗意见是什么服务	询问增值服务内容
百万信天游租赁车与网约车的异同	释义项的定义
专家门诊fwxm是什么服务	询问增值服务内容
乳腺体检异常指标检出率数据分析	某种体检异常指标分析
信诚附加轻症豁免保险费bxzl的投保年龄？	询问投保年龄
信诚附加轻症豁免保险费bxzl的保险责任？	询问保险责任
保单贷款	询问保单借款
产品优势	询问产品优势
合作银行	询问合作银行
公司股东	公司股东构成
缴费年期	询问缴费年期
保证续保	询问保险条款
怎么交钱	保费支付渠道
缴费方式	询问缴费方式
投保资料	投保所需资料
合作医院	询问合作医院
保障范围	询问保险责任
酒后开车条款	询问保险条款
受益人指定	询问受益人
保全变更	询问合同变更
电子合同	电子合同介绍
保险责任	询问保险责任
减额交清	询问减额缴清
保障期限	询问保险期间
官方微信	询问公司介绍
保险期间	询问保险期间
犹豫期退保	询问犹豫期
客服上班时间	咨询时间
电话医生号码	询问增值服务内容
电话医生时间	询问增值服务内容
全程导医服务	询问增值服务内容
康爱保保障期限	产品保障期限
基因检测地点	询问增值服务内容
康爱保缴费方式	询问缴费方式
基因检测拒保	询问增值服务内容
康爱保保额限制	产品保额限制
基因检测内容	询问增值服务内容
重疾治疗费用	疾病种类治疗费用
基因检测标准	询问增值服务内容
在线问诊时间	询问增值服务内容
尊崇会员二级服务项目	询问增值服务内容
重疾fwxm服务内容	询问增值服务内容
忘记交保费怎么办	忘记交保费的解决办法
尊崇会员一级服务项目	询问增值服务内容
fwxm预约挂号费用	询问增值服务内容
尊崇会员三级服务项目	询问增值服务内容
良性肿瘤良性肿瘤赔吗	某种疾病是否在承保范围内
住院治疗过程跨越保单年度	询问保险条款
租赁车、网约车意外bxj	某种情景是否可以投保
投资连结保险账户介绍	投资连结保险投资账户介绍
康爱保生命特别保险金最高赔付比例是？	询问赔付比例
良性肿瘤	疾病的定义
小病	疾病的定义
复效	询问复效期
指定	询问受益人
酒后开车	情景的定义
报销	产品费用与报销
轻症名称	疾病种类的定义
保险单借款	询问保单借款
重疾名称	疾病种类的定义
微理赔	理赔渠道申请流程
轻症豁免	疾病种类的定义
重疾保额	疾病种类的定义
信用卡保费	保费支付渠道
人寿保险责任准备金	询问保险责任
酒后开车有保吗	某种情景是否可以投保
康爱保的宽限期	询问宽限期时间
良性肿瘤保障范围	某种疾病的保障范围
复效期有没有滞纳金	复效期有无收取滞纳金
先天性遗传良性肿瘤投保	患某疾病是否可以投保
康爱保保险事故的通知？	询问保险事故通知
康爱保	产品介绍
月缴	询问缴费年期
受益人	询问受益人
退保	询问合同解除
体检标准	体检标准
bxzl	险种介绍
官微	询问公司介绍
最低偿付能力	公司经营状况
康爱保体检标准	体检标准
提供保险条款	询问保险条款
健康状况要求	询问如实告知
会员级别	询问增值服务内容
售后联系	询问增值服务内容
关于放射疗法	释义项的定义
绿医通道	询问增值服务内容
保单现金价值	询问现金价值
电话医生	询问增值服务内容
保险公司倒闭	公司经营状况
康爱保价格	询问产品价格
关于化学疗法	释义项的定义
投保方式	某渠道的投保流程
健康告知核保	询问如实告知
及时通知保险公司	询问保险事故通知
能优惠吗	购买某项保险产品有无优惠
尊逸会员服务项目	询问增值服务内容
未成年人投保限额	特殊人群投保限额
康爱保最低保额	某产品的最低保额
未成年人投保规则	特殊人群投保规则
康爱保我们认可的医院？	理赔医院
酒后开车保不保？	某种情景是否可以投保
良性肿瘤赔吗	某种疾病是否在承保范围内
尊尚会员服务项目	询问增值服务内容
尊享会员服务项目	询问增值服务内容
康爱保年缴保险费？	询问缴费年期
fwxm使用期限	询问增值服务内容
良性肿瘤患者投保	患某疾病是否可以投保
fwxm使用流程	询问增值服务内容
三甲医院fwxm	询问增值服务内容
轻症豁免如何缴费	投保指引
投保人与被保险人关系	投保人与被保险人关系
康爱保的除外责任	保障项目的责任免除详情
什么是保险？	释义项的定义
未成年人有生命特别保险金这项保险责任吗	询问保险责任
无疾而终	other
人工核保	核保不通过解决办法
异地投保	产品保障的地域限制
异地保障	产品保障的地域限制
财务问卷	财务问卷针对的对象
重大疾病保障	疾病种类的定义
康爱保重症	疾病种类的定义
生命特别保险金意外	保障项目的定义
康爱保轻症	疾病种类的定义
酒后开车是什么	释义项的定义 情景的定义
乳腺超声检查是什么	询问增值服务内容
保单借款利率	询问保单借款 查询方式
康爱保法定身份证明？	释义项的定义
航空意外bxj	某种情景是否可以投保
康爱保属于bxzl吗	产品是否属于某一类险
mri乳腺磁共振检查是什么	询问增值服务内容
偿付能力	公司经营状况
保险期限	询问保险期间
宽限期	询问宽限期定义
保险条款	询问保险条款
隔代投保	投保人与被保险人关系
fwxm服务	询问增值服务内容
关于肿瘤免疫疗法	释义项的定义
fwxm对象	询问增值服务内容
fwxm付费	询问增值服务内容
酒后开车投保	某种情景是否可以投保
山东分公司联系方式	询问分公司联系方式
山西分公司联系方式	询问分公司联系方式
辽宁分公司联系方式	询问分公司联系方式
福建分公司联系方式	询问分公司联系方式
上海分公司联系方式	询问分公司联系方式
江苏分公司联系方式	询问分公司联系方式
深圳分公司联系方式	询问分公司联系方式
浙江分公司联系方式	询问分公司联系方式
安徽分公司联系方式	询问分公司联系方式
北京分公司联系方式	询问分公司联系方式
2018第一季度偿付能力	公司经营状况
自驾车意外bxj	某种情景是否可以投保
广东分公司联系方式	询问分公司联系方式
中信保诚人寿保险公司简介	询问公司介绍
广西分公司联系方式	询问分公司联系方式
河南分公司联系方式	询问分公司联系方式
康爱保保险费垫缴	询问保费垫缴
重疾，轻症的种类	疾病种类的定义
康爱保保险事故的通知	询问保险事故通知 释义项的定义
重症疾病和轻症疾病的区别？	区分疾病种类的标准
生命特别保险金	保障项目的定义
关于肿瘤内分泌疗法	释义项的定义
除外责任	保障项目的责任免除详情
开门红fwxm	询问增值服务内容
酒后开车赔付	某情景是否在承保范围内
意外保不保	某种情景是否可以投保
员工优惠	某人购买产品是否有优惠
康爱保疾病bxj	某种情景是否可以投保
什么是bxzl	疾病种类的定义 险种介绍
公共交通意外bxj	某种情景是否可以投保
乳腺x线钼靶检查是什么	询问增值服务内容
康爱保意外bxj	某种情景是否可以投保
附加险现金价值	询问附加险 询问现金价值
客服热线变更保单信息	询问合同变更
fwxm	询问增值服务内容
fwxmfwxm	询问增值服务内容
治疗费用良性肿瘤	疾病治疗费用
康爱保保险合同的种类	询问合同种类
对于重症监护室的要求	释义项的定义
bxzl	险种介绍
肿瘤标志物的意义	释义项的定义
康爱保保险责任	询问保险责任
有没有什么bxzl推荐	产品推荐
酒后开车，可以购买吗	某种情景是否可以投保
重疾体检标准	体检标准
生命特别保险金支付方式	保障项目的赔付
康爱保专科医生？	询问专科医生
国外理赔流程	理赔申请后出现特殊情况的解决办法
康爱保保险单借款	询问保单借款
良性肿瘤算重症吗	某疾病是否属于某疾病种类
重疾保障种类范围	疾病种类包含哪些疾病
轻症赔付流程	疾病种类的赔付流程
康爱保的生命特别保险金、生命特别保险金免责条款（除外责任）？	保障项目的责任免除详情
康爱保保单贷款利息？	询问保单借款
康爱保的生命特别保险金？	保障项目的定义
生命特别保险金给付有限制吗	询问保险金给付 保障项目的赔付
重疾种类	疾病种类的定义
理赔上门服务	理赔申请后出现特殊情况的解决办法
如何申领康爱保生命特别保险金、生命特别保险金？	保障项目如何申请理赔
生命特别保险金	保障项目的定义
申请生命特别保险金	保障项目如何申请理赔
申请康爱保生命特别保险金	保障项目如何申请理赔
酒后开车导致的重疾可以理赔吗	得了某类疾病怎样申请理赔 某情景是否在承保范围内
良性肿瘤保不保；	某种疾病是否在承保范围内
良性肿瘤赔不赔	某种疾病是否在承保范围内
良性肿瘤有赔付吗？	某种疾病是否在承保范围内
申请酒后开车理赔需要递交的资料	得了某类疾病怎样申请理赔 某情景是否在承保范围内 保障项目如何申请理赔
申请康爱保生命特别保险金	保障项目如何申请理赔
生命特别保险金赔付流程	疾病种类的赔付流程
康爱保理赔了生命特别保险金后主险保额会因此降低吗？生命特别保险金有	保障项目的理赔方式
生命特别保险金理赔资料	保障项目的理赔方式
为未成年人投保，酒后开车保额和重疾责任保额需要累计附加康爱保	特殊人群投保规则
申请康爱保生命特别保险金	保障项目如何申请理赔
生命特别保险金理赔资料	保障项目的理赔方式
申请理赔	得了某类疾病怎样申请理赔 保障项目如何申请理赔 得了某个疾病怎样申请理赔
理赔流程	得了某类疾病怎样申请理赔 保障项目如何申请理赔 得了某个疾病怎样申请理赔
你们有哪些产品啊	询问公司有哪些产品
nihao	other
康爱保的保障期多久	产品保障期限
哈哈哈	other
重疾种类	疾病种类的定义
专享电话医生	询问增值服务内容
康爱保保障期多久	产品保障期限
康爱保最高投保保额是多少	产品保额限制
康爱保的交费年期	询问缴费年期
康爱保附加险变更规则	询问附加险
全名无忧可选保额吗	询问保额规定
购买康爱保可以附加什么附加险	询问附加险
康爱保的产品优势	询问产品优势
例如1岁	other
康爱保保额有规定吗	询问保额规定
康爱保非年缴保费的折算系数是什么	保费核算
你们有那些产品	询问公司有哪些产品
康爱保保的是什么	产品介绍
康爱保能否赔偿良性肿瘤	保障项目的理赔方式
康爱保都有那些保障内容呢/	询问保险责任
这两个有什么区别	询问区别
有一份暖宝保还可以投保康爱保吗	保险是否有购买限制
我想算一下保费	保费核算
康爱保可以保费垫缴吗	询问保费垫缴
康爱保的（1）疾病bxj	保障项目的定义
全名无忧理赔医院要求	理赔医院
哈哈	other
全名无忧住院前几天可以在赔付范围内	赔付方式
康爱保退保是退保费	询问合同解除
康爱保财务规则	投保指引
保费测试	保费核算
康爱保的缴费方式	询问缴费方式
111	other
（5）租赁车、网约车意外bxj	某种情景是否可以投保
康爱保的等待期	询问等待期
康爱保可以申请减额缴清么	询问减额缴清
康爱保保多久	产品保障期限
康爱保的投保年龄多大	询问投保年龄
康爱保的职业核保规则	投保指引
那康爱保呢	产品介绍
康爱保的诉讼时效是多长	询问诉讼时效
那信天游呢	产品介绍
康爱保怎么申请升级康爱保	产品升级介绍
信天游满期返还	产品期满返还
康爱保可以单独附加amr（信诚附加意外伤害医疗保险）吗	询问附加险
康爱保专科医生	询问专科医生
投保年龄	询问投保年龄
全名无忧的投保年龄	询问投保年龄
康爱保投保书填写	询问投保书填写
康爱保最高可以投保多少	产品保额限制
康爱保对职业的要求	投保的职业要求
隔代投保	投保人与被保险人关系
康爱保的四个特色是什么	询问产品优势
康爱保的诉讼期是多久	询问诉讼时效
康爱保有没有复效期	询问复效期
康爱保如何理赔	保障项目的理赔方式
康爱保保额限制	产品保额限制
13751846655	other
康爱保的交费方式	询问缴费方式
得了轻症，豁免保费了之后，保单还有现金价值吗	豁免保费后保单是否存在现金价值
信天游保什么的	询问保险责任
康爱保的保障范围多大	询问保险责任
湖北呢	other
康爱保可以附加其他附加险吗	询问附加险
信天游保障到几岁	产品保障期限
良性肿瘤	疾病的定义
保障期多久	产品保障期限
康爱保是什么	产品介绍
康爱保的财务规则	投保指引
保险责任	询问保险责任
康爱保的变更通信方式	询问变更通讯方式
可以介绍一下康爱保吗	产品介绍
信天游保障	产品保障期限
康爱保和康爱保什么区别	保险产品对比
重疾体检表格	询问体检或验尸
康爱保的如何申请生命特别保险金	保障项目如何申请理赔
康爱保可以进行保单回溯吗	保单回溯
电话验证18617198791	other
北京天气	other
谁能买	投保人条件限制
哈喽	other
免赔额是共用的吗	询问保险条款
信天游职业要求	投保的职业要求
康爱保的自驾车意外bxj	某种情景是否可以投保
投保康爱保最低保额是多少	某产品的最低保额
康爱保保险责任是什么	询问保险责任
如何获得高发肿瘤基因检测	询问增值服务内容
航空意外bxj是什么	保障项目的定义
医疗机构建议	other
康爱保有没有职业限制	投保的职业要求
康爱保的投保年龄	询问投保年龄
信天游满期	产品保障期限
如果已经有了一份中信保城的bxzl还能再买康爱保吗	保险是否有购买限制
如果投保康爱保之后乘坐公交车出了事故怎么赔	保障项目的理赔方式
康爱保与社保的区别	询问区别
康爱保除外责任	保障项目的责任免除详情
康爱保可以变更缴费方式吗	询问变更缴费方式
特定门诊医疗费	产品费用与报销
轻症	疾病种类的定义
康爱保与康爱保有什么不同	保险产品对比
我很好	other
康爱保犹豫期	询问犹豫期
康爱保的特定癌症有哪些	疾病种类包含哪些疾病
康爱保的酒后开车免责条款（除外责任）	保障项目的责任免除详情
/,@-d	other
康爱保是保证续保吗	询问保险条款
生命特别保险金是啥	保障项目的定义
信天游和金悦行都是百万两全吗	产品介绍
康爱保的附加规则	投保指引
康爱保最高赔付多少钱	询问赔付比例
尊尚会员的服务	询问增值服务内容
职业等级5级以上能否投保康爱保	投保的职业要求
境外体检	询问增值服务内容
公共交通意外bxj是什么	保障项目的定义
适用币种	询问适用币种
康爱保的赔付比例	询问赔付比例
康爱保的保障内容	询问保险责任
康爱保续期有等待期吗	询问等待期
电话号码18820096284	other
康爱保有等待期吗	询问等待期
附表1	other
最低保额是多少	某产品的最低保额
只能拥有一份有效的医疗保险吗	保险是否有购买限制
那一万是绝对免赔额还是相对免赔额	询问保险条款
如果高于20万怎么办	询问保额规定
等待期多少	询问等待期
都保哪些重疾呢	保哪些疾病
特定门诊医疗费包括什么	产品费用与报销
康爱保生命特别保险金最高赔付比例是	询问赔付比例

康爱保是否有犹豫期	询问犹豫期
良性肿瘤指哪些	疾病的定义
保哪些疾病	保哪些疾病
康爱保保险合同的种类	询问合同种类
购买康爱保是否有增值服务	询问增值服务项目
康爱保介绍	产品介绍
良性肿瘤检测的供应商	询问增值服务内容
全名无忧投保年龄	询问投保年龄
康爱保的接触保险合同	询问合同种类
康爱保可以中途退保吗	询问合同解除
康爱保免责条款	保障项目的责任免除详情
18566219075	other
康爱保最高限额	产品保额限制
乘坐租赁车发生酒后开车，怎么赔	某情景是否在承保范围内
康爱保的航空意外bxj	某种情景是否可以投保
投保康爱保可以附加附加险吗	询问附加险
那多大的人可以投保	询问投保年龄
信天游有收益吗	other
犹豫期是多久	询问犹豫期
生命特别保险金如何申请	申请某保障项目所需资料
康爱保的免赔额是多少啊	询问免赔额数值
康爱保的生命特别保险金是什么	保障项目的定义
18820785745	other
baofeicesuan	保费核算
康爱保可以申请减额缴清吗	询问减额缴清
特定门诊医疗费包含那些	产品费用与报销
什么是良性肿瘤	疾病的定义
康爱保最低能投保多少	某产品的最低保额
康爱保保障期限	产品保障期限
良性肿瘤或高发肿瘤基因检测在等待期查出会不会拒保	患某疾病是否可以投保
康爱保投保的其他规则	询问投保规则
专线电话医生	询问增值服务内容
康爱保最高可投保多少保额	保额限制
康爱保呢	产品介绍
投保康爱保之后多久可以更换缴费方式呢	询问变更缴费方式
康爱保是什么产品	产品介绍
你们公司有什么产品‘	询问公司有哪些产品
百万两全返还	产品期满返还
康爱保可以保单借款吗	询问保单借款
为什么已投保暖宝保就不能再投康爱保	保险是否有购买限制
缴几年啊	询问缴费年期
康爱保体检标准	体检标准
康爱保投保要求	询问投保规则
15088065625	other
购买康爱保，社保可以抵扣免赔额吗	other
电话验证：15072308969	other
10年	other
北京的天气	other
康爱保怎么申请理赔	保障项目的理赔方式
康爱保的免赔额表	询问免赔额数值
你们有哪些产品	询问公司有哪些产品
乘坐网约车发生意外导致酒后开车，怎么赔	某情景是否在承保范围内
犹豫期保费退保率	释义项的定义 犹豫期终止合同相关规定
康爱保与社保一样吗	询问区别
无业人员可以投保康爱保吗	投保的职业要求
我想测算一下保费	保费核算
这个保险投保年龄多大	询问投保年龄
心灵健康服务	询问增值服务内容
绿医通道在广州有哪些医院	询问增值服务内容
申请康爱保生命特别保险金	保障项目如何申请理赔
康爱保可以保多久	产品保障期限
康爱保可以变更保险金额	询问合同变更
续保有等待期吗	询问等待期
康爱保的保险单借款	询问保单借款
康爱保的保额累计规则	询问保额累计
介绍康爱保	产品介绍
你们有什么产品呢	询问公司有哪些产品
附加险能否到保险机构附加	询问附加险
体检项目及体检报告咨询	体检指引
电话验证18665868683	other
你好，你们有什么产品	询问公司有哪些产品
有什么优势呢	询问产品优势
康爱保的如实告知与保险合同的解除	询问合同解除 询问如实告知
如何申领康爱保生命特别保险金、生命特别保险金	保障项目如何申请理赔
保障年限	询问保险期间
全球紧急救援	询问增值服务内容
康爱保最低保额是多少	某产品的最低保额
良性肿瘤能否投保	患某疾病是否可以投保
康爱保保障什么	询问保险责任
康爱保的保障期限到了之后还可以续保吗	产品保障期限
康爱保重症监护室津贴一天给多少的	产品费用与报销
康爱保能否保单垫缴	询问保费垫缴
购买康爱保需要体检吗	询问体检或验尸
康爱保保啥	询问保险责任
康爱保的是多少	产品介绍
康爱保	产品介绍
康爱保的缴费上市	询问缴费方式
/ok	other
超过51周岁投保康爱保需要体检吗	询问体检或验尸
康爱保有职业限制吗	投保的职业要求
5岁小孩，首次投保康爱保保费交多少	特殊人群投保规则
有什么产品	询问公司有哪些产品
一般医疗金有多少	other
电话验证：18820096284	other
理赔速度	理赔速度
康爱保的住院医疗费用包括什么	产品费用与报销
45	other
你们有什么产品	询问公司有哪些产品
康爱保的特定门诊透析费包含那些	产品费用与报销
有关于康爱保增值服务的介绍吗	询问增值服务项目
保额累计	询问保额累计
你好、	other
生命特别保险金是什么	保障项目的定义
呵呵呵	other
康爱保的服务	询问增值服务项目
康爱保的住院费用包含那些	产品费用与报销
康爱保有没有犹豫期	询问犹豫期
康爱保可以申请保单借款吗	询问保单借款
百万bxzl介绍	产品介绍
你们都有什么产品	询问公司有哪些产品
购买康爱保，有什么增值服务	询问增值服务项目
生命特别保险金是什么	保障项目的定义
康爱保的除外责任	保障项目的责任免除详情
电话验证13286824845	other
投保康爱保酒后开车了怎么赔	保障项目的理赔方式
康爱保投保规则	询问投保规则
康爱保有没有等待期	询问等待期
康爱保怎么交钱	保费支付渠道
北京呢	other
保什么	询问保险责任
诉讼时效	询问诉讼时效
康爱保的保额规定	询问保额规定
有特别说明和约定的情况吗	询问特别约定
康爱保的犹豫期是多久	询问犹豫期
康爱保缴费期多久	询问缴费年期
康爱保最高可以买多少万	产品保额限制
那儿有分支机构吗	other
康爱保有又犹豫期吗	询问犹豫期
公共交通	other
康爱保都有那些保障内容/	询问保险责任
有多少	other
重症监护室津贴一天给多少的	产品费用与报销
康爱保银保通出单投保规则	询问投保规则
康爱保的增值服务	询问增值服务项目
康爱保的保额累计	询问保额累计
怎么赔付	赔付方式
重疾轻症的种类	疾病种类的定义
生命特别保险金	保障项目的定义
康爱保投保有什么限制吗	投保限制
租车自驾游发生意外导致酒后开车怎么赔	某情景是否在承保范围内
全程导医	询问增值服务内容
康爱保的受益人	询问受益人
信天游	产品介绍
呵呵	other
康爱保的体检标准	体检标准
12	other
康爱保的租赁车、网约车意外bxj	某种情景是否可以投保
同个保险事故，康爱保是否会出现多项生命特别保险金同时赔付（例如：自驾车意外酒后开车）	保障项目的理赔方式
投保康爱保，可以附加什么险种	询问附加险
18402010668	other
康爱保请求给付生命特别保险金的诉讼时效期间为几年	询问诉讼时效
康爱保可以续保吗	产品续保
13422226090	other
10	other
介绍一下康爱保	产品介绍
3	other
康爱保可以续保到多少岁	询问保险条款
康爱保属于什么险种	询问保险种类
保障内容	询问保险责任
康爱保的疾病bxj	保障项目的定义
您好	other
fwxm	询问增值服务内容
康爱保佩服比例	询问赔付比例
康爱保保多少年	询问保险责任
信天游有酒后开车比例赔付吗	询问赔付比例
电话验证&nbsp;13538990094	other
康爱保的住院医疗费用	产品费用与报销
康爱保保额多少	询问保额规定
康爱保条款	询问保险条款
电话验证18566219075	other
信天游保障到终老吗	产品保障期限
康爱保是否可以附加附加险	询问附加险
康爱保的全残	保障项目的定义
电话验证18820096284	other
你好呀！	other
康爱保投保有地域限制吗	产品保障的地域限制
康爱保的宽限期	询问宽限期时间
有什么产品推荐	产品推荐
保额规定	询问保额规定
康爱保的投保规则	询问投保规则
全名无忧可以申请保单借款吗	询问保单借款
帮我算一下保费	保费核算
康爱保的犹豫期	询问犹豫期
康爱保的保险责任	询问保险责任
康爱保保障期是多久呢	产品保障期限
康爱保可以保障多久呢	产品保障期限
康爱保中途退保是否有损失	询问合同解除
什么是康爱保	产品介绍
康爱保良性肿瘤	疾病的定义
自驾车保险	释义项的定义
康爱保酒后开车可以理赔吗	保障项目的理赔方式
等待期是多长	询问等待期
13590325770	other
康爱保保险事故的通知	询问保险事故通知
康爱保最高保额是多少	产品保额限制
康爱保保什么	询问保险责任
百富美喔	other
30万	other
驾车关爱	询问增值服务内容
康爱保最高保额多少	产品保额限制
康爱保的等待期是多久	询问等待期
康爱保可以附加的附加险	询问附加险
男	other
自驾车意外bxj	某种情景是否可以投保
绿医通道服务	询问增值服务内容
从事5类职业的可以投保康爱保吗	投保的职业要求
康爱保保障的疾病有哪些	产品保哪些疾病
能否附加意外医疗保险	询问附加险
康爱保的最低保额多少	某产品的最低保额
增至无法	other
免赔额怎么算	询问免赔额数值
等待期内由于疾病导致的酒后开车可以申请生命特别保险金吗	保障项目如何申请理赔 询问等待期
康爱保体检具体检查什么项目	询问体检或验尸
康爱保是否有等待期	询问等待期
保险责任是什么	询问保险责任
321	other
客户投保了康爱保，并依法成为网约车司机，在驾驶网约车期间发生意外伤害事故导致酒后开车，如在保险责任范围内，请问公司将如何给付	询问保险金给付
住院治疗费用是包括了哪些	释义项的定义
会员等级	询问增值服务内容
天气	other
康爱保可不可以保单借款	询问保单借款
32	other
康爱保投保流程	某渠道的投保流程
大于45周岁投保康爱保可以选择的缴费期是	询问缴费年期
还有其他产品吗	询问公司有哪些产品
属于什么险种啊	询问保险种类
哈哈哈哈	other
50万	other
购买康爱保，中途可以退保吗	询问合同解除
2	other
康爱保的失踪处理	询问宣告死亡 询问失踪处理
可以介绍一下你们公司吗	询问公司介绍
康爱保的意外bxj	某种情景是否可以投保
住院医疗费用生命特别保险金	保障项目的定义
自驾可以保么	某种情景是否可以投保
良性肿瘤赔不赔	是否承保某个疾病
哪些情况免赔	保障项目的责任免除详情
怎么申请理赔	保障项目如何申请理赔
犹豫期多久	询问犹豫期
保什么	询问保险责任
如何恢复合同	询问合同恢复
如何用保单向银行借款	询问保单借款
有什么特别的说明	询问特别约定
如何终止合同	询问合同终止
保险什么时候开始生效	询问合同生效
自然死亡怎么赔付	询问宣告死亡
没有如实告知有什么后果	询问如实告知
如何解除合同	询问合同解除
保险期间是多久	询问保险期间
保险费垫缴有什么用	询问保费垫缴
保险的受益人是谁	询问受益人
为什么要验尸	询问体检或验尸
有未归还款项，会给付生命特别保险金吗	询问未归还款项偿还
保险合同都有哪些文件	询问合同构成
发生争议如何处理	询问争议处理
投保年龄是多少	询问投保年龄
能用美元支付吗	询问适用币种
基本保险金额是如何确定的	询问基本保险金额
这是什么类型的保险	询问合同种类
等待期有多久	询问等待期
减额缴清是什么	询问减额缴清
缴费方式有哪些	询问缴费方式
缴费年期是什么	询问缴费年期
这个保险保哪些疾病	保哪些疾病
你们有哪些产品	询问公司有哪些产品
康爱保有多少天宽限期呢	询问宽限期时间
什么是宽限期	询问宽限期定义
为什么要买	询问产品优势
免赔额多少	询问免赔额数值
缴纳保险费有什么需要注意的吗	询问保险费缴纳
诉讼时效是多久	询问诉讼时效
如何变更联系方式	询问变更通讯方式
生命特别保险金怎么给付	询问保险金给付
晚上问问题有时间限制吗	咨询时间
全残是否可以投保	患某疾病是否可以投保
保单借款必须在6个月内归还本息吗？	保单借款的还款期限
酒后开车可以投保吗	某种情景是否可以投保
bxzl是指什么	保险种类的定义
酒后开车赔不赔	某情景是否在承保范围内
什么是重大疾病	疾病种类的定义
生命特别保险金是什么	保障项目的定义
怎么申请理赔	得了某类疾病怎样申请理赔
失踪了怎么处理	询问失踪处理
重疾包含哪些	疾病种类包含哪些疾病
良性肿瘤算重大疾病吗	某疾病是否属于某疾病种类
年龄报错了怎么办	询问信息误告
疾病种类有哪些	询问疾病种类包含哪些
日常生活中如何更好的预防良性肿瘤的发生	某种疾病的预防
乳腺异常高发区域	某种疾病的高发区域
乳腺体检异常指标检出率数据分析	某种体检异常指标分析
乳腺体检异常指标是什么	某种体检异常指标定义
乳房的构成	身体器官的构成
良性肿瘤的发病原因	疾病发病原因
b超检查项目有哪些	某项体检的包含项
微信平台绑定及使用流程	某平台使用方法
合同去哪里领取	询问合同领取方式
手机是否可以投保	投保途径
可以帮父母买吗	投保人和被保险人关系
轻症和重疾的标准是什么	区分疾病种类的标准
未成年人有生命特别保险金这项保险责任吗	保障项目的年龄限制
你们公司经营和偿付水平不错吧	公司经营状况
特殊职业方面有要求吗	投保的职业要求
买尊享能享受个税优惠吗	购买某项保险产品有无优惠
附加险的费用是一年一年交的吗？	某类险种的缴费方式
近半年的体检结果能用吗	体检的时限要求
中信银行手机投保流程	某渠道的投保流程
有社保和没社保的价格会有不同吗	保险费定价
微理赔	理赔渠道申请流程
康爱保最低保额	某产品的最低保额
理赔“生命特别保险金”后，客户缓缴的余下各期保费将如何处理？	理赔后缓缴保险费的处理办法
客户申领生命特别保险金时，除了常规理赔资料外，还需提供哪些特殊资料？	申请某保障项目所需资料
公司股东	公司股东构成
赔了重症可以赔轻疾吗？	不同保障项目的重复理赔
康爱保价格	询问产品价格
介绍一下你们公司	询问公司介绍
康爱保属于bxzl吗	产品是否属于某一类险
异地投保	承保区域
重疾赔付次数	保障项目的赔付次数
怎么交钱	保费支付渠道
财务问卷	财务问卷针对的对象
重疾治疗费用	疾病种类治疗费用
未成年人投保规则	特殊人群投保规则
为什么选50万保额	推荐保额
核保不通过怎么办？	核保不通过解决办法
体检标准	体检标准
投保资料	投保所需资料
提供保险条款	询问保险条款
全国定点理赔医院	理赔医院
轻症赔付	保障项目的赔付
bxzl	险种介绍
有没有什么bxzl推荐	产品推荐
在国外可以使用中信银行app吗？	工具的使用限制
给付型保险	保险类型判断
诊断证明病理报告会很难拿吗？	诊断报告的领取
员工优惠	某人购买产品是否有优惠
康爱保可以升级为康爱保吗？	产品升级介绍
达到体检保额	体检指引
康爱保保额限制	产品保额限制
未成年人父母双亡可以买康爱保吗？	某情景是否具备购买产品资格
bxzl的生存期	询问疾病种类的生存期
去国外能赔吗	理赔的地域限制
未成年人投保限额	特殊人群投保限额
申请保单借款后还能申请减额缴清吗？	权益间的关系
生命特别保险金意外	保障项目的保障范围
康爱保	产品介绍
手机上投保有纸质合同吗？	申请纸质合同
轻症赔付流程	疾病种类的赔付流程
理赔速度	理赔速度
康爱保投保有地域限制吗	产品保障的地域限制
合同丢失	合同丢失
电子合同	电子合同介绍
保单真假	保单查询
理赔条件	理赔条件
住院可以报销的吗	赔付方式
如何投保	投保指引
办理业务都需要提供保单原件吗	业务办理提交材料
投保人与被保险人关系	投保人与被保险人关系
什么人可以作为投保人？	投保人条件限制
红利领取的规定	红利申请规定
什么情况下信托合同自动终止	合同自动终止的情景
理赔报案的目的	理赔报案的目的
险种关联选择申请资料	险种关联选择申请资料
变更投保人的规定	变更投保人
产品利率及投连价格查询	查询方式
怎么申请理赔	得了某个疾病怎样申请理赔
良性肿瘤赔不赔生命特别保险金	疾病是否赔某个保障项目
酒后开车赔不赔生命特别保险金	情景是否赔偿某个保障项目
酒后开车是什么	情景的定义
解释一下良性肿瘤	疾病的定义
发生事故后如何通知保险公司	询问保险事故通知
良性肿瘤包含哪些	疾病包含哪些疾病
如何申请保单借款	如何申请某项服务
我们指定的医院是指	释义项的定义
天津分公司联系方式	询问分公司联系方式
康爱保的复效期多长时间	询问复效期
生命特别保险金赔付多少	询问赔付比例
康爱保投保规则	询问投保规则
指定第二投保人的规则	询问投保人
缴费的方式中途可以更换吗	询问变更缴费方式
康爱保的现金价值	询问现金价值
康爱保属于什么险种	询问保险种类
良性肿瘤赔不赔	某种疾病是否在承保范围内
复效期有没有滞纳金	复效期有无收取滞纳金
减额交清有什么影响	减额缴清的影响
增加保额	询问保额
终身是99岁吗	险种的年龄限制
良性肿瘤保障范围	某种疾病的保障范围
高发疾病	高发疾病
保障期限	产品保障期限
忘记交保费怎么办	忘记交保费的解决办法
购买过其他保险，有冲突吗	保险是否有购买限制
理赔了生命特别保险金后，有幸活过6个月，那后期怎么办？	理赔申请后出现特殊情况的解决办法
豁免保费后保单借款	豁免保费后保单是否存在现金价值
手机投保月缴首期	投保渠道的月缴首期
生命特别保险金给了一半后，保费还需要缴吗？	保障项目给付一半后的处理方法
小孩不足1周岁患病怎么赔付？	特殊人群的理赔方式
国外医院要求	国外医院的要求
康爱保	产品介绍
投资连结保险账户介绍	投资连结保险投资账户介绍
增值服务有什么	询问增值服务项目
重大疾病fwxm	询问增值服务内容
康爱保认可的医院	询问合作医院
最低保多少啊	询问最低保额
康爱保的保额规定	询问保额规定
你们公司最好的产品是什么	询问公司定义
可以附加其他险种吗	询问附加险
康爱保专科医生？	询问专科医生
保险金额最高是多少	询问保险金额
康爱保的保额累计规则	询问保额累计
康爱保投保书填写？	询问投保书填写
如何变更合同	询问合同变更
你们的专业术语我都不太懂	咨询引导
我的月收入一万块，你看我是拿多少钱出来买保险比较好？	保费支出
你们公司地址在哪里	公司地址
山东分公司电话	询问联系方式
合作银行	询问合作银行
有社保还需要买吗	商业保险与医保的关系
康爱保有保单回溯功能吗	保单回溯
良性肿瘤是什么	疾病的定义
bxzl是什么	保险种类的定义
免赔额的定义是什么？ 询问免赔额定义
能自动续保吗	产品续保
续保怎么操作？	产品续保
续保流程是怎么样的?	产品续保
如何续保？	产品续保
怎么交？	保费支付渠道
缴费方式	询问缴费方式
可以月缴吗	询问缴费年期	
几年交费	询问缴费年期
可以选择月交吗	询问缴费年期
支付方式	询问缴费方式
月缴和季缴有什么不同	询问缴费年期
保证续保吗	产品续保	
是不是一定可以续保？	产品续保
是不是无条件续保的呢？	产品续保
续保有什么要求吗？	产品续保
为什么已投保暖宝保就不能再投全民无忧	保险是否有购买限制
我没了暖宝保还能买全民无忧吗？	保险是否有购买限制
《全民无忧》和《暖宝保》只能拥有一份吗？	保险是否有购买限制
我投保了《暖宝保》，就不能投保《全民无忧》了吗	保险是否有购买限制
为什么已投保暖宝保就不能再投全民无忧	保险是否有购买限制
我没了暖宝保还能买全民无忧吗？	保险是否有购买限制
《全民无忧》和《暖宝保》只能拥有一份吗？	保险是否有购买限制
我投保了《暖宝保》，就不能投保《全民无忧》了吗	保险是否有购买限制
一般医疗保险金和恶性肿瘤医疗保险金共用保额吗	询问保额
整个保障只保50万吗？	询问保额
一般医疗保险金和恶性肿瘤医疗保险金是加起来50万吗？	询问保额
50万的保额可以申请保险的项目有哪些？	询问保额
免赔额是共用的吗	询问免赔额定义
免赔额是不是分开算的？	询问免赔额定义
免赔额里面包括什么项目？	询问免赔额定义
合同到期后还有保障吗	询问合同解除
保障到什么时候？	产品保障期限
住院跨越了保单年度，那之后的要怎么算？	other
合同满期后住院还可以申请报销吗？	产品费用与报销
理赔审核中可以先退还病历资料吗	other
可以退还病历吗？	other
能拿回病历吗？	other
报销完后，会退回病历吗？	产品费用与报销
理赔后的收据和发票还能取回吗	产品费用与报销
报了，能再退回发票吗？	产品费用与报销
报了，能再拿回发票吗？	产品费用与报销
报了，能再给回发票吗？	产品费用与报销
宽限期	询问宽限期定义
什么是宽限期？	询问宽限期定义
保险缓交	询问宽限期定义
尊享惠康有多少天宽限期呢	询问宽限期时间
尊享惠康有多少天的宽限期	询问宽限期时间
缓缴保费	询问宽限期定义
尊享惠康的宽限期是多少天	询问宽限期时间
什么事宽限期？	询问宽限期定义
全民无忧有宽限期吗？	询问宽限期时间
全民无忧是短期险吗？	询问宽限期定义
全民无忧的保障期多久？	产品保障期限
全民无忧的保一年吗？	产品保障期限
全民无忧为什么没有等待期？	询问等待期
已经买过住院医疗险能否再投保全民无忧	保险是否有购买限制
别家买过了，能再买吗？	保险是否有购买限制
我已经买了一份医疗险了，可以在买吗？	保险是否有购买限制
之前买过了同样作用的，能再次买吗？	保险是否有购买限制
重症监护室保险金给付有限制吗	保障项目的赔付
ICU津贴怎么赔？	保障项目的赔付
ICU津贴有最高限额吗？	保障项目的赔付
ICU津贴按照什么标准来赔付？	保障项目的赔付
赔付完毕后，合同会终止吗	询问合同终止
50万赔完了，就合同终止了吗？	询问合同终止
赔完50万，还有额外保障吗？	询问合同终止
赔付完毕后是不是意味着合同终止呢？	询问合同终止
有单位的公费医疗按有社保人士投保还是非社保人士投保	other
有公费的算是有医保吗？	other
公费医疗算是医保吗？	other
有公费可以报，算医保吗？	other
入住重症监护室后，除了床位费，其他的器械治疗费用能包吗	询问保险责任
入住重症监护室，具体怎么赔付？	询问保险责任
入住ICU，具体怎么赔付？	询问保险责任
住ICU，具体怎么赔付？	询问保险责任
治疗原位癌可以算在恶性肿瘤治疗保险金当中吗？	保障项目保哪些疾病
原位癌的治疗能在恶性肿瘤费用里吗？	保障项目保哪些疾病
原位癌的治疗能在恶性肿瘤费用里能吗？	保障项目保哪些疾病
原位癌的治疗费用可以申请恶性肿瘤保险金吗？	保障项目保哪些疾病
可以保单回溯吗	申请保单回溯
能回溯吗？	申请保单回溯
可以回溯吗？	申请保单回溯
什么情况下可以申请保单回溯？	申请保单回溯
全民无忧投保有地域限制吗	产品保障的地域限制
投保有地域限制吗？	产品保障的地域限制
我在广州（XX），能投保吗？	承保区域
可以跨区购买吗？	承保区域
体检规则	体检指引
需要体检吗？	体检指引
有体检要求吗？	体检指引
多大年龄需要体检？	体检指引
保全变更	询问合同变更
可以保全吗？	询问合同变更
变更保全可以吗？	询问合同变更
如何申请保全变更？	询问合同变更
全民无忧投保年龄要求	询问投保年龄
全民无忧的投保年龄？	询问投保年龄
全民无忧的投保年龄有什么要求？	询问投保年龄
多少岁可以投保全民无忧？	询问投保年龄
全民无忧最高可以续期到多少岁？	询问投保年龄
出生未满30天可以投保全民无忧吗？	询问投保年龄
免赔额多少	询问免赔额数值
全民无忧的免赔额是多少？	询问免赔额数值
全民无忧的一般医疗保险金和恶性肿瘤医疗保险金是公用一个免赔额吗？	other
全民无忧的免赔额包括哪些内容？	询问免赔额数值
全民无忧的免赔额可以通过哪些途径抵扣。	询问免赔额数值
社会医疗保险和公费保险获取的补偿可以用来抵扣全民无忧的免赔额吗？	询问免赔额数值
关于住院的要求	释义项的定义
什么是住院？	释义项的定义
住院的标准是什么？	释义项的定义
住院需要满足哪些条件？	释义项的定义
住院的标准不包括哪些？	释义项的定义
家庭病床属于住院的范畴吗？	释义项的定义
住院治疗费用是包括了哪些？	产品费用与报销
住院期间发生的哪些费用可以报销？	产品费用与报销
什么是住院医疗费用？	释义项的定义
膳食费是属于住院医疗费用吗？	产品费用与报销
救护车使用费是属于住院医疗费用吗？	产品费用与报销
中草药费用是属于住院医疗费用吗？	产品费用与报销
关于化学疗法	释义项的定义
什么叫做化学疗法？	释义项的定义
化学疗法是怎么定义？	释义项的定义
化学疗法的目的是什么？	释义项的定义
化学疗法对癌细胞有什么作用？	释义项的定义
化学疗法怎么解释？	释义项的定义
住院治疗过程跨越保单年度	询问保险条款
投保后有对应的售后服务吗	服务内容介绍
买了后，有售后服务吗？	服务内容介绍
买了后，需要改手机号，怎么改？	变更通讯资料相关规定
售后方式有哪些？	服务内容介绍
售后电话是多少？	询问联系方式
谁负责跟进？	other
医院要求	理赔医院
认可的医院指的哪些？	理赔医院
有规定哪些医院吗？	理赔医院
对医院有什么要求？	理赔医院
医院有没有限制	理赔医院
孕妇可以投保吗	投保人条件限制
怀孕可以投保吗？	某种情景是否可以投保
怀孕了可以投保吗？	某种情景是否可以投保
有了可以投保吗？	某种情景是否可以投保
孕妇保吗？	某种情景是否可以投保
门诊的报销有要求吗	理赔条件
怎么报销门诊费用？	理赔条件
如何报销门诊费？	理赔条件
报销门诊费需要什么资料？	理赔条件
报销门诊费需要什么条件？	理赔条件
关于放射疗法	释义项的定义
什么是放射疗法？	释义项的定义
放射疗法有什么用？	释义项的定义
放射疗法是什么？	释义项的定义
关于肿瘤免疫疗法	释义项的定义
什么是肿瘤免疫疗法？	释义项的定义
肿瘤免疫疗法是什么？	释义项的定义
肿瘤免疫疗法有什么用？	释义项的定义
关于肿瘤内分泌疗法	释义项的定义
什么是肿瘤内分泌疗法？	释义项的定义
肿瘤内分泌疗法是什么？	释义项的定义
肿瘤内分泌疗法有什么用？	释义项的定义
关于癌症靶向疗法	释义项的定义
什么是癌症靶向疗法？	释义项的定义
癌症靶向疗法是什么？	释义项的定义
癌症靶向疗法有什么用？	释义项的定义
对于重症监护室的要求	询问增值服务内容
重症监护室的定义	释义项的定义
怎样才算重症监护室	询问增值服务内容
重症监护室的标准	询问增值服务内容
医学必要的定义	释义项的定义
医学必要是什么意思？	释义项的定义
怎样才算医学必要？	释义项的定义
怎么理解医学必要？	释义项的定义
全名无忧可选保额吗	询问保额
全民无忧的保额是多少？	询问保额
全民无忧的保额是固定的吗？	询问保额
全民无忧最高保额是多少？	询问保额
对被保人的职业有要求吗	投保的职业要求
有没有什么职业不能买？	投保的职业要求
有没有职业要求？	投保的职业要求
什么职业不能投保？	投保的职业要求
百万信天游的最低保额	某产品的最低保额
百万信天游的最低保额是多少？	某产品的最低保额
投保百万信天游的最低保额是多少？	某产品的最低保额
百万信天游最低可以买多少保额？	某产品的最低保额
投保百万信天游最低可以买多少？	某产品的最低保额
百万信天游的职业核保规则	投保指引
投保人限制	投保人条件限制
投保职业限制	投保的职业要求
拒保职业	投保的职业要求
特殊投保	投保人条件限制
百万信天游“银保通”出单特别规定	产品保额限制
百万信天游银保通出单限额	产品保额限制
百万信天游银保通出单最高保额	产品保额限制
百万信天游银保通出单要求	产品保额限制
百万信天游累计保额	询问保额累计
百万信天游的保险期间	产品保障期限
百万信天游可以保障多久？	产品保障期限
百万信天游能保障多久？	产品保障期限
百万信天游的保障期？	产品保障期限
百万信天游保险费垫缴	询问保费垫缴
百万信天游可以申请垫缴吗？	询问保费垫缴
百万信天游可不可以申请垫缴？	询问保费垫缴
百万信天游如何申请垫缴？	询问保费垫缴
百万信天游保险单借款	询问保单借款
百万信天游可以申请保单借款吗？	询问保单借款
百万信天游可不可以申请保单借款？	询问保单借款
百万信天游如何申请保单借款？	询问保单借款
申请百万信天游疾病全残保险金	保障项目如何申请理赔
申请百万信天游疾病全残保险金需要的资料有哪些？	申请某保障项目所需资料
申请百万信天游疾病全残保险金需要有哪些资料？	申请某保障项目所需资料
申请理赔需要提供什么资料？	理赔需要的材料
申请百万信天游意外全残保险金	保障项目如何申请理赔
申请百万信天游意外全残保险金需要的资料有哪些？	申请某保障项目所需资料
申请百万信天游意外全残保险金需要有哪些资料？	申请某保障项目所需资料
申请全残保险金需要提供什么资料？	申请某保障项目所需资料
申请百万信天游满期保险金	保障项目如何申请理赔
怎么申请满期保险金？	保障项目如何申请理赔
满期保险金如何申请？	保障项目如何申请理赔
申请满期保险金的资料？	申请某保障项目所需资料
百万信天游的缴费期	询问缴费年期
缴费期	询问缴费年期
怎么缴费？	询问缴费方式
怎么选择缴费？	询问缴费年期
百万信天游保额限制	产品保额限制
保额限制	产品保额限制
限额	产品保额限制
百万信天游保额有什么要求？	产品保额限制
百万信天游疾病身故或全残保险金	保障项目的定义
疾病身故或全残怎么赔？	保障项目的赔付
疾病身故或全残赔多少？	保障项目的赔付
身故后怎么赔付？	保障项目的赔付
百万信天游意外身故或全残保险金	保障项目的定义
意外身故或全残怎么赔？	保障项目的赔付
意外身故或全残赔多少？	保障项目的赔付
全残或身故怎么赔付？	保障项目的赔付
公共交通意外身故或全残保险金	保障项目的定义
公共交通工具身故或全残怎么赔？	保障项目的赔付
公共交通工具身故或全残赔多少？	保障项目的赔付
公共交通工具身故或全残按照什么标准赔付？	保障项目的赔付
自驾车意外身故或全残保险金	保障项目的定义
自驾车身故或全残怎么赔？	保障项目的赔付
自驾车身故或全残赔多少？	保障项目的赔付
自驾车导致的身故或全残怎么赔付？	保障项目的赔付
租赁车、网约车意外身故或全残保险金	保障项目的定义
租赁车、网约车意外身故或全残怎么赔？	保障项目的赔付
租赁车、网约车意外身故或全残赔多少？	保障项目的赔付
租赁车、网约车导致的身故或全残按照什么标准赔付？	保障项目的赔付
航空意外身故或全残保险金	保障项目的定义
航空意外身故或全残怎么赔？	保障项目的赔付
航空意外身故或全残赔多少？	保障项目的赔付
航空意外身故或全残按照什么标准赔付？	保障项目的赔付
百万信天游满期保险金	保障项目的定义
满期保险金赔多少？	保障项目的理赔方式
满期保险金是多少？	保障项目的理赔方式
满期保险金怎么算？	保障项目的理赔方式
百万信天游的投保规则	询问投保规则
投保规则	询问投保规则
附加险投保规则	询问附加险 询问投保规则
保全规则	询问投保规则
百万信天游的保额累计规则	询问保额累计
累计保额	询问保额累计
风险保额	询问保额累计
体检保额	询问保额累计
百万信天游的附加规则	询问附加险
附加险规则	询问附加险
附加险附加要求	询问附加险
百万信天游可以添加附加险吗？	询问附加险
百万信天游的健康核保规则	询问投保规则
投保限制	询问投保规则
什么情况会拒保？	询问投保规则
投保需要体检吗？	询问投保规则
百万信天游的保全规则	保全规则
百万信天游保全方式	保全规则
百万信天游有哪些保全？	保全规则
百万信天游售后	服务内容介绍
百万信天游可以变更缴费方式吗？	询问变更缴费方式
交费方式转换	询问变更缴费方式
年交转季缴	询问变更缴费方式
季缴转年交	询问变更缴费方式
百万信天游可以变更保险金额吗？	询问合同变更
增额要求	询问合同变更
保额调整	询问合同变更
可以修改保额吗？	询问合同变更
百万信天游赠送的信享卡增值服务需要客户激活吗？	询问增值服务内容
信享卡启用申请	询问增值服务内容
信享卡起用	询问增值服务内容
怎么激活信享会的增值服务？	询问增值服务内容
职业等级5级以上能否投保百万信天游？	投保的职业要求
职业要求	投保的职业要求
职业限制	投保的职业要求
高危职业不可投	投保的职业要求
百万信天游非年缴保费的折算系数是什么？	询问缴费方式
季缴换年交要换算吗？	询问变更缴费方式
变更交费方式要换算吗？	询问变更缴费方式
非年缴保费的折算系数怎么算？	询问变更缴费方式
百万信天游可以单独附加AMR（信诚附加意外伤害医疗保险）吗？	询问附加险
百万信天游是单独的主险吗？	询问附加险
有没有意外医疗报销？	询问附加险
百万信天游可以附加意外伤害医疗保险吗？	询问附加险
百万信天游的财务规则	other
财务核保通则	other
财务核保规定	other
财务核保应交材料	other
百万信天游租赁车与网约车的异同	询问区别
租车和约车都能保不？	other
租和和约车保的是否都一样？	询问区别
租赁车与网约车有什么不同？	询问区别
百万信天游的除外责任	保障项目的责任免除详情
百万信天游不保事项	保障项目的责任免除详情
百万信天游免责	保障项目的责任免除详情
百万信天游有什么免责条款吗？	询问免责条款
已缴费年期数	询问缴费年期
交了多少年？	询问缴费年期
累计交了多少期？	询问缴费年期
年缴方式下的标准年缴保险费	保费核算
年交的保费才是标准保费？	保费核算
标准保费按年化计算	保费核算
公共交通工具	释义项的定义
公用交通工具	释义项的定义
合法营运车辆	释义项的定义
公交车	释义项的定义
自驾车	释义项的定义
私家车	释义项的定义
居家旅行车	释义项的定义
小轿车	释义项的定义
租赁车	释义项的定义
租车	释义项的定义
个人租车	释义项的定义
神州租车	释义项的定义
网约车	释义项的定义
滴滴打车	释义项的定义
优步	释义项的定义
拼车	释义项的定义
全民无忧属于什么险种	询问保险种类
全民无忧是属于医疗险吗？	产品是否属于某一类险 
全民无忧是报销型保险吗？	保险类型判断
全民无忧是属于给付型保险吗？	保险类型判断
全民无忧保什么	询问保险责任
全民无忧的保险责任是什么？	询问保险责任
全民无忧的保险责任有哪些？	询问保险责任
全民无忧保险金有哪三个？	询问保险责任
全民无忧的主要内容是什么？	询问保险责任
一般医疗保险金	保障项目的定义
什么是一般医疗保险金？	保障项目的定义
一般医疗保险金怎么解释？	保障项目的定义
一般医疗保险金的内容是什么？	保障项目的定义
一般医疗保险金保什么？	保障项目的保障范围 询问保险责任
恶性肿瘤医疗保险金	保障项目的定义
什么是恶性肿瘤医疗保险金？	保障项目的定义
恶性肿瘤医疗保险金怎么解释？	保障项目的定义
恶性肿瘤保险金的内容是什么？	保障项目的定义
恶性肿瘤保险金保什么?	保障项目的保障范围 询问保险责任
重症监护室保险金	保障项目的定义
什么是重症监护室保险金？	保障项目的定义
重症监护室保险金怎么解释？	保障项目的定义
重症监护室保险金的内容是什么？	保障项目的定义
重症监护室保险金有多少天的免赔天数？	保障项目的理赔方式
恶性肿瘤	疾病的定义
癌症是可以保的吧	患某疾病是否可以投保
癌症怎么保	患某疾病是否可以投保
所有的恶性肿瘤都保吗	患某疾病是否可以投保
肿瘤是什么意思	疾病的定义
癌症赔吗	某种疾病是否在承保范围内
皮肤癌保吗	患某疾病是否可以投保
恶性肿瘤	疾病的定义
癌症保不保	患某疾病是否可以投保 某种疾病是否在承保范围内
银保通出单康爱保，对客户职业有限制吗？	投保的职业要求
银保通出单康爱保，对客户职业有要求吗？	投保的职业要求
银保通渠道投保康爱保，对客户的职业有要求吗？	投保的职业要求
康爱保保单生效后，可以更改缴费方式吗？	询问变更缴费方式
康爱保保单生效后，可以选择改变缴费方式吗？	询问变更缴费方式
康爱保保单生效后，缴费方式可以改变吗？	询问变更缴费方式
什么情况下可以申请变更缴费方式？	询问变更缴费方式
康爱保的保险责任？	询问保险责任
康爱保是保什么的？	询问保险责任
康爱保保什么内容？	询问保险责任
康爱保的保障内容是什么？	询问保险责任
康爱保的恶性肿瘤保险金？	保障项目的定义
康爱保的恶性肿瘤保险责任？	询问保险责任
康爱保的恶性肿瘤保险内容？	询问保险责任
什么是恶性肿瘤保险金？	保障项目的定义
康爱保的特别癌症保险金？	保障项目的定义
康爱保的特别癌症的保险责任？	询问保险责任
康爱保的特别癌症的保险内容？	询问保险责任
什么是特别癌症保险金？	保障项目的定义
康爱保的身故保险金？	保障项目的定义
康爱保的身故保险责任？	询问保险责任
康爱保的身故保险内容？	询问保险责任
被保人去世后如何理赔？	保障项目的理赔方式
如何申领康爱保恶性肿瘤保险金、特定癌症保险金？	保障项目如何申请理赔
如何申请理赔康爱保恶性肿瘤保险金、特定癌症保险金？	保障项目如何申请理赔
如何获得康爱保恶性肿瘤保险金、特定癌症保险金？	保障项目如何申请理赔
怎么申请理赔康爱保恶性肿瘤保险金、特定癌症保险金？	保障项目如何申请理赔
如何申领康爱保身故保险金？	保障项目如何申请理赔
如何申请理赔康爱保身故保险金？	保障项目如何申请理赔
如何获得理赔康爱保身故保险金？	保障项目如何申请理赔
怎么申请理赔康爱保身故保险金？	保障项目如何申请理赔
康爱保理赔快吗？	理赔速度
康爱保理赔速度怎么样？	理赔速度
康爱保理赔时速怎么样？	理赔速度
理赔时效	理赔速度
康爱保保险事故的通知？	询问保险事故通知
康爱保发生保险事故的通知是多少天？	询问保险事故通知
发生风险后，要在几天内通知保险事故？	询问保险事故通知
对康爱保保险事故的通知的时效有什么要求吗？	询问保险事故通知
康爱保已缴费年期数？	询问缴费年期
康爱保已缴年期？	询问缴费年期
康爱保已经缴费的时间？	询问缴费年期
康爱保遗传性疾病？	疾病的定义
康爱保遗传病？	疾病的定义
康爱保能保遗传性疾病？	某种疾病是否在承保范围内
遗传性疾病在保障范围内吗？	某种疾病的保障范围
康爱保先天性畸形、变形或染色体异常？	疾病的定义
康爱保的先天性疾病？	疾病的定义
康爱保先天性畸形？	疾病的定义
什么是先天性畸形、变形或染色体异常？	疾病的定义
康爱保法定身份证明？	释义项的定义
康爱保的身份证明？	释义项的定义
康爱保的有效身份证明？	释义项的定义
康爱保法定身份证包括哪些？	释义项的定义
康爱保我们认可的医院？	理赔医院
康爱保可理赔的医院？	理赔医院
康爱保认可的医院？	理赔医院
理赔医院有什么要求？	理赔医院
康爱保保单贷款利息？	other
康爱保贷款利息？	other
康爱保利息？	other
贷款利息	other
脑癌	疾病的定义
恶性脑肿瘤	疾病的定义
骨癌	疾病的定义
骨恶性肿瘤	疾病的定义
前列腺癌	疾病的定义
前列腺恶性肿瘤	疾病的定义
肝癌	疾病的定义
肝恶性肿瘤	疾病的定义
乳腺癌	疾病的定义
乳腺恶性肿瘤	疾病的定义
宫颈癌	疾病的定义
宫颈恶性肿瘤	疾病的定义
康爱保体检标准？	体检标准
康爱保体检要求？	体检指引
购买康爱保保额多少需要体检?	体检指引
购买康爱保多少岁需要体检？	体检指引
康爱保的特色？/亮点？	询问产品优势
康爱保有什么特点？	询问产品优势
康爱保有什么优势？	询问产品优势
康爱保有什么用？	询问产品优势
康爱保和其它产品对比有什么不同？	询问产品优势
康爱保其他规则？	询问投保规则
康爱保因为什么会拒保？	询问投保规则
康爱保会拒保吗？	询问投保规则
康爱保的拒保规则是什么？	询问投保规则
康爱保的拒保规则有哪些？	询问投保规则
康爱保增值服务？	询问某产品增值服务项目
康爱保赠送的服务是什么？	询问某产品增值服务项目
康爱保赠送的服务有什么？	询问某产品增值服务项目
康爱保可以赠送什么服务？	询问某产品增值服务项目
投保康爱保有什么可以赠送？	询问某产品增值服务项目
康爱保赠送的增值服务使用时间次数？	增值服务使用次数 增值服务使用时间
康爱保赠送的服务使用期是多久？	增值服务使用时间
康爱保赠送的服务可以使用多久？	增值服务使用时间
康爱保赠送的服务能使用多久？	增值服务使用时间
康爱保赠送的服务能使用几次？	增值服务使用次数
申请百万信天游疾病身故保险金	保障项目如何申请理赔
疾病身故怎么赔？	某情景下全残或身故赔偿
疾病身故有赔吗？	某情景下全残或身故赔偿
疾病身故赔的是什么？	某情景下全残或身故赔偿
疾病身故可以赔吗？	某情景下全残或身故赔偿
疾病身故理赔资料？	某情景下全残或身故赔偿
百万信天游的产品优势	询问产品优势
产品亮点	询问产品优势
产品有什么特别优势？	询问产品优势
亮点之处	询问产品优势
优势之处	询问产品优势
最大优势	询问产品优势
民航班机	释义项的定义
乘坐非民航班机可以赔吗？	某情景是否在承保范围内
民航班机怎么解释？	释义项的定义
只有乘坐民航班机出险才赔吗？	某情景是否在承保范围内
什么是民航班机？	释义项的定义
民航班机的标准是怎样的？	释义项的定义
酒后驾驶	释义项的定义
酒后驾驶赔吗？	某情景是否在承保范围内
什么是酒后驾驶？	释义项的定义
酒后驾驶是怎么定义的？	释义项的定义
酒后驾驶是违法的吗？	释义项的定义
酒后驾驶怎么解释？	释义项的定义
无合法有效驾驶证驾驶	情景的定义
什么叫做无合法有效驾驶证驾驶？	情景的定义
什么情况才叫无合法有效驾驶证驾驶？	情景的定义
没有取得驾驶资格叫做无合法有效驾驶证驾驶？	情景的定义
无合法有效驾驶证驾驶有那些条件才符合？	情景的定义
无合法有效驾驶证驾驶怎么解释？	情景的定义
机动车	释义项的定义
什么是机动车？	释义项的定义
机动车怎么解释？	释义项的定义
机动车包括哪些车辆？	释义项的定义
机动车的是怎么定义的？	释义项的定义
机动车的定义是什么？	释义项的定义
百万信天游保险合同的种类	询问合同种类
百万信天游的保险责任？	询问保险责任
百万信天游的保险责任包括哪些？	询问保险责任
百万信天游的保障范围？	询问保险责任
百万信天游保什么？	询问保险责任
百万信天游有哪些保险金？	产品介绍
百万信天游保险事故的通知	询问保险事故通知
百万信天游发生了保险事故要多久之内通知我们？	询问保险事故通知
百万信天游的保险事故通知时效是多久？	询问保险事故通知
买了百万信天游发生了保险事故超过五天通知会怎样？	询问保险事故通知
买了百万信天游发生了保险事故不及时通知会有什么后果？	询问保险事故通知
买了百万信天游发生保险事故要注意哪些事项？	询问保险事故通知
白血病	疾病的定义
白血病属于重疾的保障范围吗？	某种疾病的保障范围 某疾病是否属于某疾病种类
血癌	疾病的定义
白血病赔不赔	某种疾病是否在承保范围内 某种疾病是否在承保范围内
白血病在不在保障范围	某种疾病的保障范围
白血病怎么算	某种疾病的保障范围
白血病重疾保吗	患某疾病是否可以投保
白血病保不保	患某疾病是否可以投保
重疾种类	疾病种类包含哪些疾病
重疾保障范围	某种疾病的保障范围
保哪些重疾	疾病种类包含哪些疾病
保多少种重疾	疾病种类包含哪些疾病
重疾有多少种	疾病种类包含哪些疾病
你们的产品都保哪些重症疾病	产品保哪些疾病
你们的产品都保哪些重大疾病	产品保哪些疾病
你们的产品都保哪些重疾	疾病种类包含哪些疾病
哪90种重疾	疾病种类包含哪些疾病
90种重症	疾病种类包含哪些疾病
都有哪90种重疾	疾病种类包含哪些疾病
90种重大疾病	疾病种类包含哪些疾病
90种重疾条款	询问保险条款
90种疾病具体有哪些	疾病种类包含哪些疾病
90种重大疾病种类	疾病种类包含哪些疾病
90种重大疾病条款	询问保险条款
哪90种重大疾病	疾病种类包含哪些疾病
重疾90种	疾病种类包含哪些疾病
具体是哪90种重大疾病	疾病种类包含哪些疾病
你可以给我介绍一下重疾都包括哪一些	疾病种类包含哪些疾病
可以给我介绍一下你们的产品都保哪些重大疾病么？	疾病种类包含哪些疾病
重疾包括哪几种	疾病种类包含哪些疾病
90种是哪种	疾病种类包含哪些疾病
哪九十种	疾病种类包含哪些疾病
重疾包括哪些	疾病种类包含哪些疾病
重大疾病有哪些	疾病种类包含哪些疾病
90种大病都有什么	疾病种类包含哪些疾病
尊享惠康90种类	疾病种类包含哪些疾病
重疾绿医通道具体怎样的？	询问增值服务内容
重疾绿医通道有什么作用	询问增值服务内容
重疾绿医通道是干什么用的	询问增值服务内容
重疾绿通的使用	询问增值服务内容
终极绿衣通道怎么用？	询问增值服务内容
我需要怎么样才可以获得终级率一通道？	询问增值服务内容
重疾绿医通道只有患重疾才可以使用吗？	询问增值服务内容
重疾绿医只有患重疾才可以使用吗？	询问增值服务内容
重疾绿医通道患轻症可以使用吗	询问增值服务内容
重疾绿医轻症能否使用	询问增值服务内容
重疾赔付次数	保障项目的赔付次数
重疾赔付几次	保障项目的赔付次数
这个可以赔几次	保障项目的赔付次数
尊享惠康重症保险金可以多次赔付吗	保障项目的赔付次数
重症保险金可以赔付多少次	保障项目的赔付次数
重症保险金赔付次数可以是多次吗	保障项目的赔付次数
这个保险可以赔几次	保障项目的赔付次数
重大疾病赔多少次	保障项目的赔付次数
重疾，轻症的种类	疾病种类包含哪些疾病
重疾90种，轻症40种有哪些	疾病种类包含哪些疾病
重疾90种，轻症40种是什么	疾病种类包含哪些疾病
健康保障	other
您好，尊享惠康保障多少种重疾？	疾病种类包含哪些疾病
轻症保障有哪些	疾病种类包含哪些疾病
保几种病	疾病种类包含哪些疾病
哪些病能保？	疾病种类包含哪些疾病
尊享惠康保障范围有哪些	询问保险责任
脑中风赔吗	某种疾病是否在承保范围内
脑中风赔吗？	某种疾病是否在承保范围内
保障疾病	询问保险责任
重疾和轻症的种类有哪些	疾病种类包含哪些疾病
附加险 现金价值	询问附加险 询问现金价值
附加险有现金价值？附加险的现金价值可以进行保单借款吗？	询问附加险 询问保单借款 询问现金价值
附加险 保单借款	询问附加险 询问保单借款
除外责任	保障项目的责任免除详情
违法犯罪是不赔的吗	某情景是否在承保范围内
酒驾赔吗	某情景是否在承保范围内
潜水保吗	某种情景是否可以投保
酒驾保不保？	某种情景是否可以投保
尊享惠康的除外责任	保障项目的责任免除详情
隔代投保	投保人与被保险人关系
未成年人可以隔代投保吗？	特殊人群投保规则 投保人与被保险人关系
爷爷帮孙子买可以吗	投保人和被保险人关系
爷爷可以帮孙子购买尊享惠康吗	投保人和被保险人关系
高发癌症基因检测是去哪里检测？	询问增值服务内容
可以在哪检测高发癌症基因检测呢？	询问增值服务内容
我需要检查高发癌症基因检测，不知道在哪？	询问增值服务内容
要用癌筛怎么弄	询问增值服务内容
高血压保不保；	患某疾病是否可以投保
高血压是否属轻症？	某疾病是否属于某疾病种类
高血压属于保障范围吗	某种疾病的保障范围
高血压是不是在保障范围内呢？	某种疾病的保障范围
高血压能否赔偿	某种疾病是否在承保范围内
康爱保的保障期是？	产品保障期限
康爱保的保障期是多少？	产品保障期限
康爱保的保障时间是多少？	产品保障期限
康爱保的保障时间是有限制的吗？	产品保障期限
康爱保的投保年龄？	询问投保年龄
康爱保对投保年龄有限制的吗？	投保人条件限制
康爱保对投保人的年龄有限制吗？	投保人条件限制
康爱保的投保年龄是多少？	询问投保年龄
康爱保特定癌症保险金最高赔付比例是？	询问赔付比例
康爱保特定癌症保险金最多赔付多少？	询问赔付比例
康爱保特定癌症保险金最高赔付是多少？	询问赔付比例
康爱保特定癌症保险金最高可以赔付多少？	询问赔付比例
康爱保的最高保额？	产品保额限制
康爱保有保额限制吗？	产品保额限制
康爱保限制保额购买吗？	产品保额限制
康爱保最高可以选择多少保额？	产品保额限制
康爱保的保额规定？	询问保额规定
康爱保的保额规定是多少？	询问保额规定 
康爱保的最低保额是多少？	某产品的最低保额
康爱保有规定最低保额吗？	某产品的最低保额
康爱保变更缴费方式？	询问变更缴费方式
康爱保可以变更缴费方式吗？	询问变更缴费方式
康爱保的缴费方式有哪些？可以变更吗？	询问变更缴费方式
投保后可以修改缴费方式吗？	询问变更缴费方式
赔过重疾过后，身故还能赔吗	不同保障项目的重复理赔
重疾保险金赔付后，身故还有的赔吗	不同保障项目的重复理赔
赔过重疾保险金之后，终老还能赔吗	不同保障项目的重复理赔
身故 全残 给付	询问保险金给付
身故或全残如何给付保险金？	询问保险金给付
全残怎么赔	某情景下全残或身故赔偿
身故免责条款	询问免责条款
身故免责条款是？	询问免责条款
身故免责条款	询问免责条款
人寿 免责条款	询问免责条款
免赔条款	询问免责条款
主险合同免责条款	询问免责条款
无责免陪	询问免责条款
对于身故的免责条款有哪些	询问免责条款
身故免责三项	询问免责条款
身故免责条款包括哪些	询问免责条款
死亡赔付免责条款	询问免责条款
身故或全残保险金	保障项目的定义
给付过什么特别关爱金，没活过六个月怎么赔	询问保险金给付
致死赔不赔	某情景下全残或身故赔偿
身故 全残 保障	某种情景是否可以投保
身故赔付	某情景下全残或身故赔偿
身故怎么赔	某情景下全残或身故赔偿
身故或全残保险金	保障项目的定义
身故保险金	保障项目的定义
人死了赔钱吗	某情景下全残或身故赔偿
人没了，钱怎么拿出来	保障项目的理赔方式
身故怎么赔？	保障项目的理赔方式
死了怎么赔	保障项目的理赔方式
未成年人身故赔付	特殊人群的理赔方式
轻症 重疾 定义	疾病种类的定义
轻症和重疾怎么定义呢？	疾病种类的定义
大病	疾病种类的定义
轻症	疾病种类的定义
你们的疾病是怎么定义的	疾病种类的定义
轻疾和重症有什么区别	区分疾病种类的标准
哪些病要达到指定程度才算重疾	疾病种类的定义
对于病种是怎么定义的呢	疾病种类的定义
对于病种是怎么定义的呢？	疾病种类的定义
重症和轻症有什么不同	区分疾病种类的标准
重症和轻症有什么区别	区分疾病种类的标准
重症和和轻症有什么区别	区分疾病种类的标准
重症是什么	疾病种类的定义
你们的疾病是怎么定义的？	疾病种类的定义
重症是什么意思	疾病种类的定义
重疾是什么意思	疾病种类的定义
轻症是什么	疾病种类的定义
轻疾是什么	疾病种类的定义
轻症是什么意思	疾病种类的定义
轻疾是什么意思	疾病种类的定义
轻症名称	疾病种类的定义
保哪些轻症	产品保哪些疾病
有哪些轻症	疾病种类包含哪些疾病
具体病种	疾病种类包含哪些疾病
轻症种类	疾病种类包含哪些疾病
轻症保障范围	询问保险责任
有哪些轻症	疾病种类包含哪些疾病
轻症保哪些	产品保哪些疾病
保多少种轻症	产品保哪些疾病
你们的产品都保哪些轻疾	产品保哪些疾病
你们的产品都保哪些轻症	产品保哪些疾病
你们的产品都保哪些轻症疾病	产品保哪些疾病
轻症有哪些	疾病种类包含哪些疾病
轻症包括哪些	疾病种类包含哪些疾病
40种疾病有哪些	疾病种类包含哪些疾病
保的病种	产品保哪些疾病
轻症类型	疾病种类包含哪些疾病
轻症疾病有哪些	疾病种类包含哪些疾病
轻症豁免	释义项的定义
保费豁免	释义项的定义
轻症豁免如何缴费	询问缴费方式
轻症豁免的费用是一年一年缴的吗？	询问缴费方式
这款产品是不是有清症豁免	疾病种类豁免
尊享惠康可以附加轻症豁免吗？	询问附加险
轻症赔付	疾病种类的赔付流程
轻症保险金	保障项目的定义
轻症赔付金	保障项目的赔付
轻症怎么赔付？	疾病种类的赔付流程
患了轻症怎么赔	疾病种类的赔付流程
轻症赔付几次	保障项目的赔付次数
轻疾保障金	保障项目的定义
轻症赔付次数	保障项目的赔付次数
轻症给付次数	保障项目的赔付次数
轻症疾病保险金	保障项目的定义
辽宁分公司联系方式	询问分公司联系方式
辽宁分公司电话	询问分公司联系方式
辽宁分公司地址	公司地址
辽宁机构	询问分公司联系方式
达到体检保额	体检指引
购买尊享惠康，如果保额达到体检保额，是先体检再购买吗？	体检指引
购买多少保额需要体检	体检指引
100万要体检吗	体检指引
尊享惠康体检保额	体检指引
50岁客户最高免体检保额是多少	体检指引
体检的标准	体检标准
这个保险保什么	询问保险责任
你们保险保什么	询问保险责任
你们产品保什么	询问保险责任
罗列一下产品内容	产品介绍
退保	询问合同解除
什么时候可以退保	询问合同解除
撤单	询问合同解除
没什么用，想退了	询问合同解除
中途退保有损失吗？	询问合同解除
中途退保会怎么样？	询问合同解除
可以中途退保吗？	询问合同解除
中途可以退保吗？	询问合同解除
我要终止	询问合同解除
我不要这份单	询问合同解除
退保损失多少	询问合同解除
酒驾判定	释义项的定义
如果客户是因为喝了一点酒，但是没有达到醉驾的程度，造成死亡赔不赔？	某情景下全残或身故赔偿
醉驾赔付吗	某情景是否在承保范围内
酒后驾驶	情景的定义
重大疾病保险金	保障项目的定义
患重疾怎么赔	疾病种类的赔付流程
重疾 赔付	疾病种类的赔付流程
重疾保险金怎么赔付	疾病种类的赔付流程
重疾 给付	疾病种类的赔付流程
小孩3周岁患病怎么赔付	特殊人群的理赔方式
重大疾病保险金 赔付流程	保障项目的理赔方式
重大疾病保险金 申请赔付	保障项目的理赔方式
重疾 申请理赔流程	得了某类疾病怎样申请理赔
确诊就赔吗	得了某类疾病怎样申请理赔 
康爱保绿通使用次数	增值服务使用次数
康爱保绿通能用多少次	增值服务使用次数
康爱保绿通次数限制	增值服务使用次数
康爱保绿通数量限制	增值服务使用次数
康爱保绿通能用几次	增值服务使用次数
康爱保绿通有没有使用次数限制	增值服务使用次数
康爱保绿通有没有次数限制	增值服务使用次数
康爱保绿通有没有使用次数要求	增值服务使用次数
康爱保绿通有没有次数要求	增值服务使用次数
康爱保绿通使用时间	增值服务使用时间
康爱保绿通开始时间	增值服务使用时间
康爱保绿通截止时间	增值服务使用时间
康爱保绿通使用时效	增值服务使用时间
康爱保绿通有效期	增值服务使用时间
康爱保绿通使用有效期	增值服务使用时间
康爱保绿通什么时候能开始用	增值服务使用时间
康爱保绿通什么时候可以用	增值服务使用时间
康爱保绿通什么时候可以开始用	增值服务使用时间
康爱保绿通什么用到什么时候	增值服务使用时间
康爱保绿通什么用多久	增值服务使用时间
康爱保绿通服务亮点	增值服务亮点
康爱保绿通亮点	增值服务亮点
康爱保绿通特色	增值服务亮点
康爱保绿通优点	增值服务亮点
康爱保绿通好处	增值服务亮点
康爱保绿通特点	增值服务亮点
重大疾病保险金理赔资料	理赔资料
轻症疾病保险金理赔资料	理赔资料
理赔需要什么资料	理赔资料
理赔资料	理赔资料
重大疾病保险金理赔资料	理赔资料
癌症特别关爱金理赔资料	理赔资料
理赔材料	理赔资料
重大疾病保险金如何给付	保障项目的赔付
云助理电话	询问联系方式
资讯热线	询问联系方式
人工电话多少	询问联系方式
电话多少？	询问联系方式
服务电话	询问联系方式
有没有电话？	询问联系方式
客服	询问联系方式
云助理	询问联系方式
人工服务时间	咨询时间
热线电话是多少	询问联系方式
山东 合作医院	询问合作医院
山东 绿通	询问增值服务内容
山东分公司联系方式	询问分公司联系方式
山东分公司电话	询问联系方式
山东分公司地址	公司地址
山东机构	询问公司介绍
山西 合作医院	询问合作医院
山西 绿通	询问增值服务内容
山西分公司联系方式	询问分公司联系方式
山西分公司地址	公司地址
山西分公司电话	询问联系方式
山西机构	询问公司介绍
广东 合作医院	询问合作医院
广东 绿通	询问增值服务内容
广东&nbsp;合作医院	询问合作医院
广州有什么合作医院	询问合作医院
广东 医院	询问合作医院
广东分公司联系方式	询问分公司联系方式
广东分公司地址	公司地址
广东分公司电话	询问联系方式
广东机构	询问公司介绍
广东机构在哪	公司地址
广东省广州市	公司地址
广州分支机构在哪	公司地址
广州公司	公司地址 询问公司介绍
广东省有分公司吗	询问公司介绍
国外理赔流程	理赔渠道申请流程
国外理赔流程是怎么样？	理赔渠道申请流程
国内买的保险，在国外就医了，如何进行理赔	保障项目的理赔方式
在国外看病申请理赔的流程	保障项目如何申请理赔
国外理陪的流程	理赔渠道申请流程
国外理陪流程是怎么样	理赔渠道申请流程
在线问诊 健康评测 内容	询问增值服务内容
在线问诊 健康评测 对象	询问增值服务内容
在线问诊 健康评测 使用次数	询问增值服务内容
什么是在线问诊	询问增值服务内容
在线医生	询问某产品增值服务项目
什么是健康测评	询问增值服务内容
健康测平	询问增值服务内容
健康测评是做什么的	询问增值服务内容
健康测评服务	询问增值服务内容
在线问诊服务	询问增值服务内容
在线问诊或健康测评的操作？	询问增值服务内容
在线问诊 操作	询问增值服务内容
健康评测 操作	询问增值服务内容
如何健康评测	询问增值服务内容
专业心理咨询	询问增值服务内容
健康测评在哪里	询问增值服务内容
在线看医生	询问增值服务内容
建康测试	询问增值服务内容
去哪里在线问诊？	询问增值服务内容
在哪里在线问诊？	询问增值服务内容
怎么健康测评	询问增值服务内容
如何健康测评	询问增值服务内容
垫缴	询问保费垫缴
保险费的垫缴	询问保费垫缴
保险费的垫脚	询问保费垫缴
尊享惠康可以保费垫交吗	询问保费垫缴
基因检测 内容	询问增值服务内容
基因检测 服务项目	询问增值服务内容
基因检测 男女项目	询问增值服务内容
肠癌检测怎么操作	询问增值服务内容
高发肿瘤 基因检测	询问增值服务内容
高发肿瘤基因检测使用	询问增值服务内容
高发肿瘤基因检测项目	询问增值服务内容
肿瘤检测	询问增值服务内容
高发肿瘤基因检测使用次数	询问增值服务内容
什么是基因检测	询问增值服务内容
体检的定义	询问体检或验尸
基因检测是什么	询问增值服务内容
基因检测 标准	询问增值服务内容
获得高发肿瘤基因检测	询问增值服务内容
如何获得基因检测	询问增值服务内容
基因检测 使用条件	询问增值服务内容
高发肿瘤基因检测服务	询问增值服务内容
高发肿瘤基因检测的条件	询问增值服务内容
如何获得高发肿瘤基因检测这个增值服务	询问增值服务内容
基因检测地点	询问增值服务内容
高发癌症基因检测是去哪里检测？	询问增值服务内容
去哪里检测？	询问增值服务内容
基因检测 如何操作	询问增值服务内容
基因检测 怎么使用	询问增值服务内容
基因检测 流程	询问增值服务内容
高法基因检测需要客户自己去医院检测吗/	询问增值服务内容
基因检测快递费用	询问增值服务内容
癌症基因检测样品快递费用是客户到付吗？	询问增值服务内容
快递费谁出？	询问增值服务内容
基因检测怎么做	询问增值服务内容
癌筛怎么检测	询问增值服务内容
基因怎么检测	询问增值服务内容
高发肿瘤基因怎么使用呢	询问增值服务内容
高发肿瘤基因检测去哪里使用	询问增值服务内容
增值服务	询问某产品增值服务项目
买了保险，有什么可以额外送的吗	购买某项保险产品有无优惠
附加赠送	购买某项保险产品有无优惠
礼物	购买某项保险产品有无优惠
体检	询问体检或验尸
有赠送	购买某项保险产品有无优惠
可以打折吗	购买某项保险产品有无优惠
优惠	购买某项保险产品有无优惠
优惠活动	购买某项保险产品有无优惠
基因检测服务	询问增值服务内容
尊享惠康的服务	询问某产品增值服务项目
尊享惠康有哪些服务	询问某产品增值服务项目
说说你们的服务	询问某产品增值服务项目
癌症筛查	疾病的定义 询问增值服务内容
增值服务	询问某产品增值服务项目
现在有什么送	购买某项保险产品有无优惠
现在购买有什么优惠	购买某项保险产品有无优惠
买保险有什么优惠	购买某项保险产品有无优惠
有什么增值服务	询问某产品增值服务项目
你们有提供尊贵客户的专属服务吗	询问增值服务内容
产品的服务有哪一些啊？	询问某产品增值服务项目
有什么优惠活动	购买某项保险产品有无优惠
有哪些增值服务	询问某产品增值服务项目
现在有什么送的	购买某项保险产品有无优惠
增值服务介绍。	询问某产品增值服务项目
尊享惠康包括哪些增值服务	询问某产品增值服务项目
尊享惠康有什么增值服务	询问某产品增值服务项目
公司有哪些增值服务？	询问某产品增值服务项目
现在购买有什么增值服务呢	询问某产品增值服务项目
现在有哪些增值	询问增值服务内容
听说这个产品还有增值服务，可以给我介绍下吗	询问某产品增值服务项目
什么争执服务？	询问增值服务内容
<b>你们有什么服务</b>	询问某产品增值服务项目
有没有什么争执服务	询问某产品增值服务项目
有没有什么争执服务呢	询问某产品增值服务项目
怎么获得基因肿瘤检测服务	询问增值服务内容
复效	询问复效期
合同效力恢复	询问复效期
中止期后重新缴费有什么要求吗	询问复效期
中止期后重新缴费需要体检吗	询问体检或验尸 询问复效期
复效期	询问复效期
复效期是怎样的	询问复效期
合同效力恢复	询问复效期
复效期什么时候算起	询问复效期
复效期内申请复效合同还需要核保吗	询问合同恢复 询问复效期
尊享惠康的复效期多长时间	询问复效期
天津 合作医院	询问合作医院
天津 绿通	询问增值服务内容
天津分公司联系方式	询问分公司联系方式
天津分公司电话	询问联系方式
天津分公司地址	公司地址
天津机构	公司地址 公司介绍
如何投保	投保指引
这个计划怎么参加的？	投保指引
保险怎么买	投保指引
怎么缴费	询问缴费方式
标准的购买方式	投保指引
这款产品我要在哪里买呀	投保指引
怎么投保？	投保指引
去哪里买呢？	投保指引
手机投保	投保途径
APP投保	某渠道的投保流程
去哪里购买	投保指引
哪里可以购买尊享惠康	投保指引
可以用哪种方式支付	投保指引
如何购买	投保指引
尊享惠康如何购买	投保指引
缴费途径	投保指引
如何购买尊亨惠康	投保指引
你们的产品哪里值得购买	询问产品优势
去哪里购买尊享惠康	投保指引
尊享惠康的购买途径	投保指引
怎么办理购买	投保指引
如何缴费	询问缴费方式
可以选择年缴吗？	询问缴费方式
怎么缴费	询问缴费方式
交多少年合适呢_x000D_<div>	询问缴费年期
年缴是怎么缴费的	询问缴费方式
支持什么付款	保费支付渠道
可以分期付款吗	保费支付渠道
子宫肌瘤	疾病的定义
子宫肌瘤赔钱吗？	某种疾病是否在承保范围内 某种疾病是否在承保范围内
子宫肌瘤算重症吗	某疾病是否属于某疾病种类 
子宫肌瘤算轻症吗	某疾病是否属于某疾病种类 
子宫肌瘤保不保	某种疾病是否在承保范围内 某种疾病是否在承保范围内
子宫肌瘤是否属轻症	某疾病是否属于某疾病种类
子宫肌瘤属于保障范围吗？	某种疾病的保障范围 某种疾病是否在承保范围内
子宫肌瘤是不是在保障范围内呢？	某种疾病的保障范围 某种疾病是否在承保范围内
子宫肌瘤能否赔偿	某种疾病是否在承保范围内 某种疾病是否在承保范围内
子宫肿瘤算重症吗	某疾病是否属于某疾病种类
子宫肿瘤会保吗	患某疾病是否可以投保
子宫肿瘤保不保	患某疾病是否可以投保
子宫肿瘤是否属轻症	某疾病是否属于某疾病种类
子宫肿瘤属于保障范围吗	某种疾病的保障范围
子宫肿瘤是不是在保障范围内呢	某种疾病的保障范围
子宫肿瘤能否赔偿	某种疾病是否在承保范围内
宁夏 合作医院	询问合作医院
宁夏 绿通	询问增值服务内容
安徽 合作医院	询问合作医院
安徽 绿通	询问增值服务内容
受益人指定	询问受益人
我可以自己选择受益人吗	询问受益人
指定受益人	询问受益人
指定受益份额	询问受益人
变更投保人的规定	变更投保人
变更投保人的规定	变更投保人
更改投保人的规则	变更投保人
投保人身故后如何办理	询问投保人
变更投保人信息	变更投保人
可以申请终止续期保费自动转账吗	询问保险费缴纳
如何申请终止续期保费自动转账	询问保险费缴纳
如何取消续期保费自动转账	询问保险费缴纳
我不想保单自动扣费,要怎么处理	询问保险费缴纳
合作医院	询问合作医院
预约医院	询问增值服务内容
重疾绿通合作医院	询问合作医院 询问增值服务内容
得病了去哪里看	询问合作医院
合作医院有多少家	询问合作医院
能查当地有合作的银行和机构吗	询问合作医院
查当地合作医院	询问合作医院
ps合作医院。	询问合作医院
哪些医院？	询问合作医院
理赔需定点医院吗	理赔医院
合作银行	询问合作银行
去银行网点可以购买吗	询问合作银行
银行购买	询问合作银行
手机APP	投保途径
手机购买	投保途径
吉林 合作医院	询问合作医院
吉林 绿通	询问增值服务内容
售后联系	询问增值服务内容
要是买了保险，我怎么联系你们	询问联系方式
售后服务	服务内容介绍
有专人服务吗	询问增值服务内容 
售后方便吗	服务内容介绍
签合同有无经办人的	服务内容介绍
有业务员电话吗	询问联系方式
有人工吗	other
售后可以上门服务吗	服务内容介绍
四川 合作医院	询问合作医院
四川 绿通	询问增值服务内容
国内内分泌排名第一的医院	询问合作医院
国内内分泌最好的医院	询问合作医院
内分泌哪家医院最强	询问合作医院
内分泌	other
国内呼吸科排名第一的医院	询问合作医院
国内呼吸科最好的医院	询问合作医院
治疗严重慢性呼吸衰竭在全国哪家医院最好	询问合作医院
呼吸科/	询问合作医院
呼吸道疾病去哪家医院比较好	询问合作医院
国内心血管病排名第一的医院	询问合作医院
国内心血管病最好的医院	询问合作医院
心血管疾病排名第一的	询问合作医院
国内烧伤科排名第一的医院	询问合作医院
国内烧伤科最好的医院	询问合作医院
烧伤科	询问合作医院
国内眼科排名第一的医院	询问合作医院
国内眼科最好的医院	询问合作医院
眼科？	询问合作医院
眼科去哪看最好	询问合作医院
最好的眼科医院	询问合作医院
国内神经外科排名第一的医院	询问合作医院
国内神经外科最好的医院	询问合作医院
神经外科	询问合作医院
国内肿瘤学排名第一的医院	询问合作医院
国内肿瘤学最好的医院	询问合作医院
国内肿瘤最好医院	询问合作医院
看肿瘤去哪里比较好	询问合作医院
恶性肿瘤治愈率排名第一的医院是什么？	询问合作医院
排名第一恶性肿瘤医院	询问合作医院
治疗肿瘤最好的医院？	询问合作医院
国内重症医学排名第一的医院？	询问合作医院
重症医学最好的医院	询问合作医院
看癌症哪里医院最好	询问合作医院
国内麻醉科排名第一的医院	询问合作医院
国内麻醉科最好的医院	询问合作医院
麻醉科	询问合作医院
国外理赔	理赔的地域限制
国外可以理赔吗？	理赔的地域限制
在国外可以买吗	产品保障的地域限制
保险公司倒闭	公司经营状况
保险公司破产	公司经营状况
参保之后公司倒闭了，谁来赔？	公司经营状况
公司要是破产怎么办	公司经营状况
公司会不会破产	公司经营状况
公司破产我的保单怎么办	公司经营状况
保险用处	产品介绍
保险我就是不怎么懂，你能给我讲讲保险用处吗	产品介绍
保险功能	产品介绍
为什么要买保险	产品介绍
保险是什么	释义项的定义
我买保险有什么用啊	产品介绍
买保险有什么意义	产品介绍
保险责任	询问保险责任
保障内容	询问保险责任
保障范围	询问保险责任
尊享惠康的保险责任	询问保险责任
尊享惠康保险责任	询问保险责任
产品功能	询问保险责任
产品内容	询问保险责任
尊享汇康有什么保险责任啊？	询问保险责任
你们的重疾责任有哪些	询问保险责任
保险责任范围？	询问保险责任
保险责任包括神饿吗	询问保险责任
尊享惠康的保险责任有哪些	询问保险责任
报章内容。	询问保险责任
保障期限	询问保险期间
保障期限多久	询问保险期间
保多久	询问保险期间
这个产品是保终身的吗？	询问保险期间
保障多少年	询问保险期间
保险期限	询问保险期间
尊享惠康保多久	产品保障期限
保多长时间	询问保险期间
保险期间	询问保险期间
能保多长的时间	询问保险期间
偏瘫有赔付吗？	某种疾病是否在承保范围内 某种疾病是否在承保范围内
偏瘫能否赔偿	某种疾病是否在承保范围内 某种疾病是否在承保范围内
偏瘫保不保	某种疾病是否在承保范围内 某种疾病是否在承保范围内
偏瘫是否在保障范围之内	某种疾病是否在承保范围内
健康告知	询问如实告知
健康告知怎么填	询问如实告知
健康状况要求	询问如实告知
健康状况有要求吗？	询问如实告知
健康问询	询问如实告知
健康告知	询问如实告知
有什么需要告知	询问如实告知
身体健康才能参加吗	询问投保规则
全残	释义项的定义
怎么算全残	释义项的定义
全残的免责条款	询问免责条款
全残的免责条款有什么？	询问免责条款
全残免责有什么	询问免责条款
全程导医服务	询问增值服务内容
导医	询问增值服务内容
如何使用导医服务	询问增值服务内容
怎么获得导医服务	询问增值服务内容
全程导医服务的使用时间	询问增值服务内容
全程导医服务使用	询问增值服务内容
全程导医服务的使用次数	询问增值服务内容
什么是导医服务	询问增值服务内容
全程导医服务时间是多长？	询问增值服务内容
公司官网地址	询问公司介绍
你们的网址是多少	询问公司介绍
公司荣誉	询问公司介绍
中信保诚获得过什么荣誉	询问公司介绍
内蒙 合作医院	询问合作医院
内蒙 绿通	询问增值服务内容
减额交清	询问减额缴清
减额缴清	询问减额缴清
减额缴清有什么要求	询问减额缴清
减少保费	询问减额缴清
保险费垫付	询问保费垫缴
减额条件	询问减额缴清
减额交清什么意思	询问减额缴清
尊享惠康可以申请减额交清吗	询问减额缴清
尊享惠康申请减额交清有什么要求	询问减额缴清
减额缴清	询问减额缴清
减额缴清后对保额有影响吗？	减额缴清的影响
减额交情	询问减额缴清
经济状况有变可以交少些保费吗	询问减额缴清
减保条件	询问减额缴清
减保要求	询问减额缴清
减额交清对保额有影响吗	减额缴清的影响
减额缴清后有什么影响	减额缴清的影响
分红险	险种介绍
有分红险吗？	险种推荐
有投连险吗？	险种推荐
办理 保单回溯	申请保单回溯
申请 保单回溯	申请保单回溯
怎么申请保单回溯	申请保单回溯
回溯只能人工投保申请吗？	申请保单回溯
尊享惠康有保单回溯功能吗	申请保单回溯
办理终止续期保费自动转账后仍会自动划扣保费吗	询问保险费缴纳
为什么取消自动转账还会扣钱	other
为什么取消自动扣费后还会扣钱	other
取消自动转账后还在划扣保费	other
我保单的6月要到期了，我不想续期要怎么办	other
我已经终止了保单的扣费,为什么还会产生垫缴	询问保费垫缴
办理终止续期保费自动转账后能重新授权银行账户扣费吗	询问保险费缴纳
重新申请自动转账	询问合同恢复
客户做了中止转账，现在又想缴费，怎么操作	询问合同恢复
取消自动扣费后要怎么重新授权扣费	询问合同恢复
如何恢复保单自动扣钱	询问合同恢复
北京 合作医院	询问合作医院
北京 绿通	询问增值服务内容
北京分公司联系方式	询问分公司联系方式
北京分公司地址	公司地址
北京分公司电话	询问联系方式
北京机构	公司地址 询问公司介绍
北京在哪里	公司地址
原位癌 定义	疾病的定义
什么是原位癌？	疾病的定义
什么是原位癌	疾病的定义
什么原位癌？	疾病的定义
原位癌是什么	疾病的定义
原位癌怎么认定	疾病的定义
什么叫做原位癌？	疾病的定义
原位癌赔不赔	某种疾病是否在承保范围内 某种疾病是否在承保范围内
原位癌是轻症还是属于重疾？	某疾病是否属于某疾病种类
原胃癌理赔么	某种疾病是否在承保范围内
原位癌保吗	某种疾病是否在承保范围内
原位癌在不在保障范围	某种疾病的保障范围 某种疾病是否在承保范围内
去国外能赔吗	理赔的地域限制
国内买的保险移民去国外了还有的赔吗？	理赔的地域限制
赔付有没有地域性限制？	理赔的地域限制
海外就医	理赔的地域限制
海外就医能不能赔	理赔的地域限制
产品优势	询问产品优势
你们公司的产品相对其他公司的有什么优势？	询问产品优势
产品亮点	询问产品优势
你们的产品哪点好	询问产品优势
产品特色	询问产品优势
产品对比	询问产品优势
保费太贵了	other
保费比较贵	other
其他公司的保障更全面	other
保障的疾病有没有什么优势	other
你们的产品有什么优势	询问产品优势
产品有什么特别	询问产品优势
产品卖点	询问产品优势
你们公司产品哪里比较吸引人	询问产品优势
产品的亮点	询问产品优势
产品的优势	询问产品优势
跟同业比有什么优势	询问产品优势
产品的优势。	询问产品优势
总结一下产品的卖点	询问产品优势
总结一下产品的有点	询问产品优势
尊享惠康产品优势	询问产品优势
产品优势是什么	询问产品优势
产品亮点是什么	询问产品优势
这个产品有什么特别的	询问产品优势
这个产品特点。	询问产品优势
你家保险保费，优惠和其他产品对比没有任何突出的优势	询问产品优势
产品的亮点有哪些？	询问产品优势
真想会开展亮点是什么？	询问产品优势
你们的产品优势	询问产品优势
你们公司的产品相比其他公司有哪些优势?	询问产品优势
重疾险为什么要买	询问产品优势
尊享惠康优势	询问产品优势
产品利率及投连价格查询	投资连结保险投资账户介绍
保单借款利率多少	查询方式
查询借款利率	查询方式
红利储存生息的利率	查询方式
生存金储存生息的利率	查询方式
什么人可以作为投保人？	投保人条件限制
投保人条件	投保人条件限制
了解一下投保规则	询问投保规则
哪些可以是保险人	投保人条件限制
投保规定	询问投保规则
未成年人可以购买吗	特殊人群投保规则
65岁还能投保吗	特殊人群投保规则
投保人 限制	投保人条件限制
什么是保险？	保险产品的定义
保险是啥？	释义项的定义
介绍一下保险	询问公司有哪些产品
解释一下保险	释义项的定义
帮我介绍一下保险	询问公司有哪些产品
能不能帮我介绍下保险	询问公司有哪些产品
什么是重疾险	保险种类的定义
我想了解重疾险	险种介绍 保险种类的定义
能不能告诉我什么是重疾险	保险种类的定义
我想知道重疾险是什么	保险种类的定义
给我解释一下重疾险	保险种类的定义
重疾险的定义是什么	保险种类的定义
那什么是重疾险呢？	保险种类的定义
给我介绍一下重疾险吧	保险种类的定义
会员级别	询问增值服务内容
怎么成为尊崇会员	询问增值服务内容
会员分级	询问增值服务内容
会员有分级吗	询问增值服务内容
会员卡分级	询问增值服务内容
住院可以报销的吗	产品费用与报销
赔付方式	赔付方式
住院费可以保吗	产品费用与报销
住院赔不赔	产品费用与报销
住院报销赔不赔	产品费用与报销
看病医疗费用可以报销呢	产品费用与报销
住院是可以报吧？	产品费用与报销
住院能不能报销	产品费用与报销
去医院住了院能否赔付吗	产品费用与报销
体检标准	体检标准
需要体检吗	询问体检或验尸
买多少要体检	体检标准
体检项目有要求吗	体检标准
体检费用	体检指引
如果需要体检，体检费用是谁出呢？	体检指引
投保需要体检时，体检的费用是自己出吗？	询问体检或验尸
体检费是谁出的	询问体检或验尸
你们公司地址在哪里	公司地址
公司地址	公司地址
你们公司在哪里	公司地址
你们公司有哪些机构	公司地址 询问公司介绍
哪些地方有你们的机构	公司地址 询问公司介绍
怎么联系分公司	询问分公司联系方式
你们的检测机构有权威吗？	询问增值服务内容
你们的检测机构是正规的吗？	询问增值服务内容
你们的检测机构事国家承认的吗？	询问增值服务内容
检测结果准确吗？	询问增值服务内容
保单借款利率	询问保单借款 查询方式
保单借款利率是怎么样的？	询问保单借款 查询方式
保单借款利率怎么算	询问保单借款 查询方式
借款利率	询问保单借款 查询方式
贷款利息怎么计算	询问保单借款
保单的借款利率是在怎么样的呢?	询问保单借款
保险单借款利率	询问保单借款 查询方式
保单借款利率多少	询问保单借款
保单回溯	释义项定义
什么是保单回溯？	申请保单回溯
回溯	申请保单回溯
回溯什么意思	申请保单回溯
刚过生日有回溯优惠吗	购买某项保险产品有无优惠 申请保单回溯
生日件有没有特别要求	申请保单回溯
可申请回溯吗？	申请保单回溯
怎么回溯	申请保单回溯
保单贷款	释义项的定义
钱可以取出来用吗？	other
急用钱怎么办	other
资金周转	other
中途钱能不能拿出来用？	other
没钱中途可取吗	other
可以取钱吗	other
能贷款吗	询问保单借款
保单可以借款吗？	询问保单借款
中间可以取钱出来吗？	other
资金周转，可以取钱吗	other
中途可以取钱	other
中途需要钱周转，钱可以拿出来吗	other
借贷	询问保单借款
中途钱可以拿出来用吗	other
中途钱可以拿出来吗？	other
中途需要用钱	other
可以申请保单贷款吗	询问保单借款
可以申请保单借款吗？	询问保单借款
可以保单借款吗	询问保单借款
保费测算	保费核算
保费多少钱	保费核算
保费是怎么算的	保费核算
怎么男的比女的贵	保费核算
算下保费	保费核算
算费用	保费核算
30岁保20万，年交20年，费用多少	询问缴费年期
30岁，20万，20年交	询问缴费年期
女，40岁，保额30万，交20年	询问缴费年期
20万保额，月缴	询问缴费年期
59岁男性怎么购买	询问投保年龄
30岁买多少保额合适	推荐保额
关于保费方面的建议	推荐保额
30岁保多少万合适	推荐保额
帮我算了一下保费	保费核算
30岁男性10万保额多少钱	保费核算
计划书	保费核算
21岁女保额要20万	保费核算
为客户制定建议书	保费核算
我要定制计划书	保费核算
制作计划书	保费核算
零岁的宝宝买多少钱？	特殊人群投保规则
二十年交费保额三十万多少钱？	询问缴费年期
三十万。	other
40岁男性	other
可以帮我测算一下保费嘛？	保费核算
帮我算一下保费	保费核算
尊享汇康多少钱	保费核算
保额10万	other
3000元能买多少保障	保费核算
能给我一份你们的建议书么	保费核算
保额选择	推荐保额
帮我算算看，35岁要交多少钱	保费核算
你帮我说一下费用。	保费核算
可以帮我算一下费用吗？	保费核算
买得话贵吗	保费核算
需要多少费用？	保费核算
帮我评估下保险费吧	保费核算
那帮我评估一下保费	保费核算
那给我配置保费吧	保费核算
50万	other
80万保额	other
例如1岁	other
你能帮我算费用多少吗	保费核算
可以算一下费用吗	保费核算
保费计算	保费核算
缴费测算	保费核算
33岁	other
测保费	保费核算
女性，30岁，该买多少钱？	推荐保额
45岁保额50万是多少	保费核算
男性费率	保费核算
那30万呢？	other
惠康费率	保费核算
能算费用吗	保费核算
60周岁以上能作为投保人吗？	询问投保年龄
老年人能买吗	询问投保年龄
老年人能投保吗	询问投保年龄
老人家能买吗	询问投保年龄
老龄人投保限制	询问投保年龄
超过60岁还能投保吗	询问投保年龄
老年人投保规则具体是什么	询问投保规则
老年人投保要求	询问投保规则
三甲医院 绿色通道	询问增值服务内容
三甲医院通道	询问增值服务内容
三甲医院绿色通道使用条件	询问增值服务内容
三甲医院绿医通道的条件	询问增值服务内容
三甲医院绿医通道使用时间	询问增值服务内容
三甲医院绿医通道服务	询问增值服务内容
三甲医院绿医通道使用次数	询问增值服务内容
上海 合作医院	询问合作医院
上海 绿通	询问增值服务内容
上海分公司联系方式	询问分公司联系方式
上海分公司电话	询问联系方式
上海分公司地址	公司地址
上海机构	公司地址 询问公司介绍
上海公司在哪	公司地址
专业导医陪诊是什么服务	询问增值服务内容
专业导医赔诊？	询问增值服务内容
中信保诚人寿保险公司简介	询问公司介绍
介绍一下你们公司	询问公司介绍
公司介绍	询问公司介绍
你们公司靠谱吗	询问公司介绍
中信保诚是做什么的	询问公司介绍
我想了解下你们公司	询问公司介绍
公司简介	询问公司介绍
了解公司介诏	询问公司介绍
贵公司近来经营状况理想吗	公司经营状况
公司实力	询问公司介绍
之前没怎么听说过你们公司	询问公司介绍
你们是什么公司	询问公司介绍
企业简介	询问公司介绍
信诚简介	询问公司介绍
你们是什么公司啊	询问公司介绍
介绍下你们公司	询问公司介绍
你公司靠谱啊	询问公司介绍
你们公司怎么样？	询问公司介绍
中信宝诚是一家什么样的公司？	询问公司介绍
公司产介	询问公司介绍
可以简单的介绍一下公司吗？	询问公司介绍
好像你们公司都不怎么出名/	询问公司介绍
公司介绍有吗	询问公司介绍
公司有什么优势	询问公司介绍
信诚的介绍	询问公司介绍
中信保诚的历史	询问公司介绍
中途缴费停了	询问宽限期时间
中途缴费停了，有什么后果	询问宽限期时间
中间没钱缴费	询问宽限期时间
迟交费用	询问宽限期时间
买保险要求	询问投保规则
买保险有什么要求吗	询问投保规则
什么人可以买	投保人条件限制
多大可以投保	询问投保年龄
多少岁可投保	询问投保年龄
健康状况有要求吗	询问投保规则
为什么拒保了	询问投保规则
我能不能给小孩买啊	特殊人群投保规则 投保人和被保险人关系
拒保的原因	询问投保规则
乳腺增生 投保	患某疾病是否可以投保
乳腺增生是否可以投保？	患某疾病是否可以投保
乳腺增生 买保险	患某疾病是否可以投保
乳腺增生	疾病的定义
有乳腺增生可以购买尊享惠康吗	患某疾病是否可以投保
乳腺增生定义	疾病的定义
常见乳房疾病—乳腺增生	疾病的定义
什么是乳腺增生	疾病的定义
乳腺结节 投保	患某疾病是否可以投保
乳腺结节是否可以投保？	患某疾病是否可以投保
乳腺结节	疾病的定义
云助理电话	询问联系方式
资讯热线	询问联系方式
人工电话多少	询问联系方式
电话多少？	询问联系方式
服务电话	询问联系方式
有没有电话？	询问联系方式
客服	询问联系方式
云助理	询问联系方式
人工服务时间	咨询时间
热线电话是多少	询问联系方式
云南 合作医院	询问合作医院
云南 绿通	询问增值服务内容
变更通讯资料相关规定	变更通讯资料相关规定
变更通讯资料需要提交的材料	变更通讯资料相关规定
变更通讯资料需要的材料	变更通讯资料相关规定
变更通讯资料所需材料	变更通讯资料相关规定
变更通讯资料怎么申请	变更通讯资料相关规定
变更通讯资料申请流程	变更通讯资料相关规定
变更通讯资料要怎么办	变更通讯资料相关规定
变更通讯资料办理流程	变更通讯资料相关规定
银行转账授权相关规定	银行转账授权相关规定
银行转账授权需要提交的材料	银行转账授权相关规定
银行转账授权需要的材料	银行转账授权相关规定
银行转账授权所需材料	银行转账授权相关规定
银行转账授权怎么申请	银行转账授权相关规定
银行转账授权申请流程	银行转账授权相关规定
银行转账授权要怎么办	银行转账授权相关规定
银行转账授权办理流程	银行转账授权相关规定
变更投保人相关规定	变更投保人相关规定
变更投保人需要提交的材料	变更投保人相关规定
变更投保人需要的材料	变更投保人相关规定
变更投保人所需材料	变更投保人相关规定
变更投保人怎么申请	变更投保人相关规定
变更投保人申请流程	变更投保人相关规定
变更投保人要怎么办	变更投保人相关规定
变更投保人办理流程	变更投保人相关规定
更改个人身份资料相关规定	更改个人身份资料相关规定
更改个人身份资料需要提交的材料	更改个人身份资料相关规定
更改个人身份资料需要的材料	更改个人身份资料相关规定
更改个人身份资料所需材料	更改个人身份资料相关规定
更改个人身份资料怎么申请	更改个人身份资料相关规定
更改个人身份资料申请流程	更改个人身份资料相关规定
更改个人身份资料要怎么办	更改个人身份资料相关规定
更改个人身份资料办理流程	更改个人身份资料相关规定
变更签名相关规定	变更签名相关规定
变更签名需要提交的材料	变更签名相关规定
变更签名需要的材料	变更签名相关规定
变更签名所需材料	变更签名相关规定
变更签名怎么申请	变更签名相关规定
变更签名申请流程	变更签名相关规定
变更签名要怎么办	变更签名相关规定
变更签名办理流程	变更签名相关规定
保费逾期未付选择相关规定	保费逾期未付选择相关规定
保费逾期未付选择需要提交的材料	保费逾期未付选择相关规定
保费逾期未付选择需要的材料	保费逾期未付选择相关规定
保费逾期未付选择所需材料	保费逾期未付选择相关规定
保费逾期未付选择怎么申请	保费逾期未付选择相关规定
保费逾期未付选择申请流程	保费逾期未付选择相关规定
保费逾期未付选择要怎么办	保费逾期未付选择相关规定
保费逾期未付选择办理流程	保费逾期未付选择相关规定
变更受益人相关规定	变更受益人相关规定
变更受益人需要提交的材料	变更受益人相关规定
变更受益人需要的材料	变更受益人相关规定
变更受益人所需材料	变更受益人相关规定
变更受益人怎么申请	变更受益人相关规定
变更受益人申请流程	变更受益人相关规定
变更受益人要怎么办	变更受益人相关规定
变更受益人办理流程	变更受益人相关规定
领取现金红利相关规定	领取现金红利相关规定
领取现金红利需要提交的材料	领取现金红利相关规定
领取现金红利需要的材料	领取现金红利相关规定
领取现金红利所需材料	领取现金红利相关规定
领取现金红利怎么申请	领取现金红利相关规定
领取现金红利申请流程	领取现金红利相关规定
领取现金红利要怎么办	领取现金红利相关规定
领取现金红利办理流程	领取现金红利相关规定
身故保险金分期领取选择相关规定	身故保险金分期领取选择相关规定
身故保险金分期领取选择需要提交的材料	身故保险金分期领取选择相关规定
身故保险金分期领取选择需要的材料	身故保险金分期领取选择相关规定
身故保险金分期领取选择所需材料	身故保险金分期领取选择相关规定
身故保险金分期领取选择怎么申请	身故保险金分期领取选择相关规定
身故保险金分期领取选择申请流程	身故保险金分期领取选择相关规定
身故保险金分期领取选择要怎么办	身故保险金分期领取选择相关规定
身故保险金分期领取选择办理流程	身故保险金分期领取选择相关规定
变更红利领取方式相关规定	变更红利领取方式相关规定
变更红利领取方式需要提交的材料	变更红利领取方式相关规定
变更红利领取方式需要的材料	变更红利领取方式相关规定
变更红利领取方式所需材料	变更红利领取方式相关规定
变更红利领取方式怎么申请	变更红利领取方式相关规定
变更红利领取方式申请流程	变更红利领取方式相关规定
变更红利领取方式要怎么办	变更红利领取方式相关规定
变更红利领取方式办理流程	变更红利领取方式相关规定
指定第二投保人相关规定	指定第二投保人相关规定
指定第二投保人需要提交的材料	指定第二投保人相关规定
指定第二投保人需要的材料	指定第二投保人相关规定
指定第二投保人所需材料	指定第二投保人相关规定
指定第二投保人怎么申请	指定第二投保人相关规定
指定第二投保人申请流程	指定第二投保人相关规定
指定第二投保人要怎么办	指定第二投保人相关规定
指定第二投保人办理流程	指定第二投保人相关规定
复效相关规定	复效相关规定
复效需要提交的材料	复效相关规定
复效需要的材料	复效相关规定
复效所需材料	复效相关规定
复效怎么申请	复效相关规定
复效申请流程	复效相关规定
复效要怎么办	复效相关规定
复效办理流程	复效相关规定
变更职业等级相关规定	变更职业等级相关规定
变更职业等级需要提交的材料	变更职业等级相关规定
变更职业等级需要的材料	变更职业等级相关规定
变更职业等级所需材料	变更职业等级相关规定
变更职业等级怎么申请	变更职业等级相关规定
变更职业等级申请流程	变更职业等级相关规定
变更职业等级要怎么办	变更职业等级相关规定
变更职业等级办理流程	变更职业等级相关规定
变更缴费方式相关规定	变更缴费方式相关规定
变更缴费方式需要提交的材料	变更缴费方式相关规定
变更缴费方式需要的材料	变更缴费方式相关规定
变更缴费方式所需材料	变更缴费方式相关规定
变更缴费方式怎么申请	变更缴费方式相关规定
变更缴费方式申请流程	变更缴费方式相关规定
变更缴费方式要怎么办	变更缴费方式相关规定
变更缴费方式办理流程	变更缴费方式相关规定
结束保险费缓缴期相关规定	结束保险费缓缴期相关规定
结束保险费缓缴期需要提交的材料	结束保险费缓缴期相关规定
结束保险费缓缴期需要的材料	结束保险费缓缴期相关规定
结束保险费缓缴期所需材料	结束保险费缓缴期相关规定
结束保险费缓缴期怎么申请	结束保险费缓缴期相关规定
结束保险费缓缴期申请流程	结束保险费缓缴期相关规定
结束保险费缓缴期要怎么办	结束保险费缓缴期相关规定
结束保险费缓缴期办理流程	结束保险费缓缴期相关规定
降低主险保额相关规定	降低主险保额相关规定
降低主险保额需要提交的材料	降低主险保额相关规定
降低主险保额需要的材料	降低主险保额相关规定
降低主险保额所需材料	降低主险保额相关规定
降低主险保额怎么申请	降低主险保额相关规定
降低主险保额申请流程	降低主险保额相关规定
降低主险保额要怎么办	降低主险保额相关规定
降低主险保额办理流程	降低主险保额相关规定
变更附加险相关规定	变更附加险相关规定
变更附加险需要提交的材料	变更附加险相关规定
变更附加险需要的材料	变更附加险相关规定
变更附加险所需材料	变更附加险相关规定
变更附加险怎么申请	变更附加险相关规定
变更附加险申请流程	变更附加险相关规定
变更附加险要怎么办	变更附加险相关规定
变更附加险办理流程	变更附加险相关规定
减额缴清相关规定	减额缴清相关规定
减额缴清需要提交的材料	减额缴清相关规定
减额缴清需要的材料	减额缴清相关规定
减额缴清所需材料	减额缴清相关规定
减额缴清怎么申请	减额缴清相关规定
减额缴清申请流程	减额缴清相关规定
减额缴清要怎么办	减额缴清相关规定
减额缴清办理流程	减额缴清相关规定
补充告知相关规定	补充告知相关规定
补充告知需要提交的材料	补充告知相关规定
补充告知需要的材料	补充告知相关规定
补充告知所需材料	补充告知相关规定
补充告知怎么申请	补充告知相关规定
补充告知申请流程	补充告知相关规定
补充告知要怎么办	补充告知相关规定
补充告知办理流程	补充告知相关规定
取消承保条件相关规定	取消承保条件相关规定
取消承保条件需要提交的材料	取消承保条件相关规定
取消承保条件需要的材料	取消承保条件相关规定
取消承保条件所需材料	取消承保条件相关规定
取消承保条件怎么申请	取消承保条件相关规定
取消承保条件申请流程	取消承保条件相关规定
取消承保条件要怎么办	取消承保条件相关规定
取消承保条件办理流程	取消承保条件相关规定
保单借款相关规定	保单借款相关规定
保单借款需要提交的材料	保单借款相关规定
保单借款需要的材料	保单借款相关规定
保单借款所需材料	保单借款相关规定
保单借款怎么申请	保单借款相关规定
保单借款申请流程	保单借款相关规定
保单借款要怎么办	保单借款相关规定
保单借款办理流程	保单借款相关规定
保单还款相关规定	保单还款相关规定
保单还款需要提交的材料	保单还款相关规定
保单还款需要的材料	保单还款相关规定
保单还款所需材料	保单还款相关规定
保单还款怎么申请	保单还款相关规定
保单还款申请流程	保单还款相关规定
保单还款要怎么办	保单还款相关规定
保单还款办理流程	保单还款相关规定
生存给付确认相关规定	生存给付确认相关规定
生存给付确认需要提交的材料	生存给付确认相关规定
生存给付确认需要的材料	生存给付确认相关规定
生存给付确认所需材料	生存给付确认相关规定
生存给付确认怎么申请	生存给付确认相关规定
生存给付确认申请流程	生存给付确认相关规定
生存给付确认要怎么办	生存给付确认相关规定
生存给付确认办理流程	生存给付确认相关规定
变更年金领取方式相关规定	变更年金领取方式相关规定
变更年金领取方式需要提交的材料	变更年金领取方式相关规定
变更年金领取方式需要的材料	变更年金领取方式相关规定
变更年金领取方式所需材料	变更年金领取方式相关规定
变更年金领取方式怎么申请	变更年金领取方式相关规定
变更年金领取方式申请流程	变更年金领取方式相关规定
变更年金领取方式要怎么办	变更年金领取方式相关规定
变更年金领取方式办理流程	变更年金领取方式相关规定
变更生存保险金领取方式相关规定	变更生存保险金领取方式相关规定
变更生存保险金领取方式需要提交的材料	变更生存保险金领取方式相关规定
变更生存保险金领取方式需要的材料	变更生存保险金领取方式相关规定
变更生存保险金领取方式所需材料	变更生存保险金领取方式相关规定
变更生存保险金领取方式怎么申请	变更生存保险金领取方式相关规定
变更生存保险金领取方式申请流程	变更生存保险金领取方式相关规定
变更生存保险金领取方式要怎么办	变更生存保险金领取方式相关规定
变更生存保险金领取方式办理流程	变更生存保险金领取方式相关规定
领取生存保险金相关规定	领取生存保险金相关规定
领取生存保险金需要提交的材料	领取生存保险金相关规定
领取生存保险金需要的材料	领取生存保险金相关规定
领取生存保险金所需材料	领取生存保险金相关规定
领取生存保险金怎么申请	领取生存保险金相关规定
领取生存保险金申请流程	领取生存保险金相关规定
领取生存保险金要怎么办	领取生存保险金相关规定
领取生存保险金办理流程	领取生存保险金相关规定
变更给付账号相关规定	变更给付账号相关规定
变更给付账号需要提交的材料	变更给付账号相关规定
变更给付账号需要的材料	变更给付账号相关规定
变更给付账号所需材料	变更给付账号相关规定
变更给付账号怎么申请	变更给付账号相关规定
变更给付账号申请流程	变更给付账号相关规定
变更给付账号要怎么办	变更给付账号相关规定
变更给付账号办理流程	变更给付账号相关规定
满期给付生存确认相关规定	满期给付生存确认相关规定
满期给付生存确认需要提交的材料	满期给付生存确认相关规定
满期给付生存确认需要的材料	满期给付生存确认相关规定
满期给付生存确认所需材料	满期给付生存确认相关规定
满期给付生存确认怎么申请	满期给付生存确认相关规定
满期给付生存确认申请流程	满期给付生存确认相关规定
满期给付生存确认要怎么办	满期给付生存确认相关规定
满期给付生存确认办理流程	满期给付生存确认相关规定
险种关联选择相关规定	险种关联选择相关规定
险种关联选择需要提交的材料	险种关联选择相关规定
险种关联选择需要的材料	险种关联选择相关规定
险种关联选择所需材料	险种关联选择相关规定
险种关联选择怎么申请	险种关联选择相关规定
险种关联选择申请流程	险种关联选择相关规定
险种关联选择要怎么办	险种关联选择相关规定
险种关联选择办理流程	险种关联选择相关规定
部分提取相关规定	部分提取相关规定
部分提取需要提交的材料	部分提取相关规定
部分提取需要的材料	部分提取相关规定
部分提取所需材料	部分提取相关规定
部分提取怎么申请	部分提取相关规定
部分提取申请流程	部分提取相关规定
部分提取要怎么办	部分提取相关规定
部分提取办理流程	部分提取相关规定
额外投资相关规定	额外投资相关规定
额外投资需要提交的材料	额外投资相关规定
额外投资需要的材料	额外投资相关规定
额外投资所需材料	额外投资相关规定
额外投资怎么申请	额外投资相关规定
额外投资申请流程	额外投资相关规定
额外投资要怎么办	额外投资相关规定
额外投资办理流程	额外投资相关规定
投资账户选择相关规定	投资账户选择相关规定
投资账户选择需要提交的材料	投资账户选择相关规定
投资账户选择需要的材料	投资账户选择相关规定
投资账户选择所需材料	投资账户选择相关规定
投资账户选择怎么申请	投资账户选择相关规定
投资账户选择申请流程	投资账户选择相关规定
投资账户选择要怎么办	投资账户选择相关规定
投资账户选择办理流程	投资账户选择相关规定
投资账户转换相关规定	投资账户转换相关规定
投资账户转换需要提交的材料	投资账户转换相关规定
投资账户转换需要的材料	投资账户转换相关规定
投资账户转换所需材料	投资账户转换相关规定
投资账户转换怎么申请	投资账户转换相关规定
投资账户转换申请流程	投资账户转换相关规定
投资账户转换要怎么办	投资账户转换相关规定
投资账户转换办理流程	投资账户转换相关规定
终止保险合同相关规定	终止保险合同相关规定
终止保险合同需要提交的材料	终止保险合同相关规定
终止保险合同需要的材料	终止保险合同相关规定
终止保险合同所需材料	终止保险合同相关规定
终止保险合同怎么申请	终止保险合同相关规定
终止保险合同申请流程	终止保险合同相关规定
终止保险合同要怎么办	终止保险合同相关规定
终止保险合同办理流程	终止保险合同相关规定
申请定期额外投资相关规定	申请定期额外投资相关规定
申请定期额外投资需要提交的材料	申请定期额外投资相关规定
申请定期额外投资需要的材料	申请定期额外投资相关规定
申请定期额外投资所需材料	申请定期额外投资相关规定
申请定期额外投资怎么申请	申请定期额外投资相关规定
申请定期额外投资申请流程	申请定期额外投资相关规定
申请定期额外投资要怎么办	申请定期额外投资相关规定
申请定期额外投资办理流程	申请定期额外投资相关规定
变更定期额外投资相关规定	变更定期额外投资相关规定
变更定期额外投资需要提交的材料	变更定期额外投资相关规定
变更定期额外投资需要的材料	变更定期额外投资相关规定
变更定期额外投资所需材料	变更定期额外投资相关规定
变更定期额外投资怎么申请	变更定期额外投资相关规定
变更定期额外投资申请流程	变更定期额外投资相关规定
变更定期额外投资要怎么办	变更定期额外投资相关规定
变更定期额外投资办理流程	变更定期额外投资相关规定
终止定期额外投资相关规定	终止定期额外投资相关规定
终止定期额外投资需要提交的材料	终止定期额外投资相关规定
终止定期额外投资需要的材料	终止定期额外投资相关规定
终止定期额外投资所需材料	终止定期额外投资相关规定
终止定期额外投资怎么申请	终止定期额外投资相关规定
终止定期额外投资申请流程	终止定期额外投资相关规定
终止定期额外投资要怎么办	终止定期额外投资相关规定
终止定期额外投资办理流程	终止定期额外投资相关规定
犹豫期减保相关规定	犹豫期减保相关规定
犹豫期减保需要提交的材料	犹豫期减保相关规定
犹豫期减保需要的材料	犹豫期减保相关规定
犹豫期减保所需材料	犹豫期减保相关规定
犹豫期减保怎么申请	犹豫期减保相关规定
犹豫期减保申请流程	犹豫期减保相关规定
犹豫期减保要怎么办	犹豫期减保相关规定
犹豫期减保办理流程	犹豫期减保相关规定
犹豫期终止合同相关规定	犹豫期终止合同相关规定
犹豫期终止合同需要提交的材料	犹豫期终止合同相关规定
犹豫期终止合同需要的材料	犹豫期终止合同相关规定
犹豫期终止合同所需材料	犹豫期终止合同相关规定
犹豫期终止合同怎么申请	犹豫期终止合同相关规定
犹豫期终止合同申请流程	犹豫期终止合同相关规定
犹豫期终止合同要怎么办	犹豫期终止合同相关规定
犹豫期终止合同办理流程	犹豫期终止合同相关规定
犹豫期其他保全变更相关规定	犹豫期其他保全变更相关规定
犹豫期其他保全变更需要提交的材料	犹豫期其他保全变更相关规定
犹豫期其他保全变更需要的材料	犹豫期其他保全变更相关规定
犹豫期其他保全变更所需材料	犹豫期其他保全变更相关规定
犹豫期其他保全变更怎么申请	犹豫期其他保全变更相关规定
犹豫期其他保全变更申请流程	犹豫期其他保全变更相关规定
犹豫期其他保全变更要怎么办	犹豫期其他保全变更相关规定
犹豫期其他保全变更办理流程	犹豫期其他保全变更相关规定
补发保单相关规定	补发保单相关规定
补发保单需要提交的材料	补发保单相关规定
补发保单需要的材料	补发保单相关规定
补发保单所需材料	补发保单相关规定
补发保单怎么申请	补发保单相关规定
补发保单申请流程	补发保单相关规定
补发保单要怎么办	补发保单相关规定
补发保单办理流程	补发保单相关规定
变更通讯资料申请时间	变更通讯资料申请时间
变更通讯资料什么时候可以申请	变更通讯资料申请时间
变更通讯资料申请开始时间	变更通讯资料申请时间
银行转账授权申请时间	银行转账授权申请时间
银行转账授权什么时候可以申请	银行转账授权申请时间
银行转账授权申请开始时间	银行转账授权申请时间
变更投保人申请时间	变更投保人申请时间
变更投保人什么时候可以申请	变更投保人申请时间
变更投保人申请开始时间	变更投保人申请时间
更改个人身份资料申请时间	更改个人身份资料申请时间
更改个人身份资料什么时候可以申请	更改个人身份资料申请时间
更改个人身份资料申请开始时间	更改个人身份资料申请时间
变更签名申请时间	变更签名申请时间
变更签名什么时候可以申请	变更签名申请时间
变更签名申请开始时间	变更签名申请时间
保费逾期未付选择申请时间	保费逾期未付选择申请时间
保费逾期未付选择什么时候可以申请	保费逾期未付选择申请时间
保费逾期未付选择申请开始时间	保费逾期未付选择申请时间
变更受益人申请时间	变更受益人申请时间
变更受益人什么时候可以申请	变更受益人申请时间
变更受益人申请开始时间	变更受益人申请时间
领取现金红利申请时间	领取现金红利申请时间
领取现金红利什么时候可以申请	领取现金红利申请时间
领取现金红利申请开始时间	领取现金红利申请时间
身故保险金分期领取选择申请时间	身故保险金分期领取选择申请时间
身故保险金分期领取选择什么时候可以申请	身故保险金分期领取选择申请时间
身故保险金分期领取选择申请开始时间	身故保险金分期领取选择申请时间
变更红利领取方式申请时间	变更红利领取方式申请时间
变更红利领取方式什么时候可以申请	变更红利领取方式申请时间
变更红利领取方式申请开始时间	变更红利领取方式申请时间
指定第二投保人申请时间	指定第二投保人申请时间
指定第二投保人什么时候可以申请	指定第二投保人申请时间
指定第二投保人申请开始时间	指定第二投保人申请时间
复效申请时间	复效申请时间
复效什么时候可以申请	复效申请时间
复效申请开始时间	复效申请时间
变更职业等级申请时间	变更职业等级申请时间
变更职业等级什么时候可以申请	变更职业等级申请时间
变更职业等级申请开始时间	变更职业等级申请时间
变更缴费方式申请时间	变更缴费方式申请时间
变更缴费方式什么时候可以申请	变更缴费方式申请时间
变更缴费方式申请开始时间	变更缴费方式申请时间
结束保险费缓缴期申请时间	结束保险费缓缴期申请时间
结束保险费缓缴期什么时候可以申请	结束保险费缓缴期申请时间
结束保险费缓缴期申请开始时间	结束保险费缓缴期申请时间
降低主险保额申请时间	降低主险保额申请时间
降低主险保额什么时候可以申请	降低主险保额申请时间
降低主险保额申请开始时间	降低主险保额申请时间
变更附加险申请时间	变更附加险申请时间
变更附加险什么时候可以申请	变更附加险申请时间
变更附加险申请开始时间	变更附加险申请时间
减额缴清申请时间	减额缴清申请时间
减额缴清什么时候可以申请	减额缴清申请时间
减额缴清申请开始时间	减额缴清申请时间
补充告知申请时间	补充告知申请时间
补充告知什么时候可以申请	补充告知申请时间
补充告知申请开始时间	补充告知申请时间
取消承保条件申请时间	取消承保条件申请时间
取消承保条件什么时候可以申请	取消承保条件申请时间
取消承保条件申请开始时间	取消承保条件申请时间
保单借款申请时间	保单借款申请时间
保单借款什么时候可以申请	保单借款申请时间
保单借款申请开始时间	保单借款申请时间
保单还款申请时间	保单还款申请时间
保单还款什么时候可以申请	保单还款申请时间
保单还款申请开始时间	保单还款申请时间
生存给付确认申请时间	生存给付确认申请时间
生存给付确认什么时候可以申请	生存给付确认申请时间
生存给付确认申请开始时间	生存给付确认申请时间
变更年金领取方式申请时间	变更年金领取方式申请时间
变更年金领取方式什么时候可以申请	变更年金领取方式申请时间
变更年金领取方式申请开始时间	变更年金领取方式申请时间
变更生存保险金领取方式申请时间	变更生存保险金领取方式申请时间
变更生存保险金领取方式什么时候可以申请	变更生存保险金领取方式申请时间
变更生存保险金领取方式申请开始时间	变更生存保险金领取方式申请时间
领取生存保险金申请时间	领取生存保险金申请时间
领取生存保险金什么时候可以申请	领取生存保险金申请时间
领取生存保险金申请开始时间	领取生存保险金申请时间
变更给付账号申请时间	变更给付账号申请时间
变更给付账号什么时候可以申请	变更给付账号申请时间
变更给付账号申请开始时间	变更给付账号申请时间
满期给付生存确认申请时间	满期给付生存确认申请时间
满期给付生存确认什么时候可以申请	满期给付生存确认申请时间
满期给付生存确认申请开始时间	满期给付生存确认申请时间
险种关联选择申请时间	险种关联选择申请时间
险种关联选择什么时候可以申请	险种关联选择申请时间
险种关联选择申请开始时间	险种关联选择申请时间
部分提取申请时间	部分提取申请时间
部分提取什么时候可以申请	部分提取申请时间
部分提取申请开始时间	部分提取申请时间
额外投资申请时间	额外投资申请时间
额外投资什么时候可以申请	额外投资申请时间
额外投资申请开始时间	额外投资申请时间
投资账户选择申请时间	投资账户选择申请时间
投资账户选择什么时候可以申请	投资账户选择申请时间
投资账户选择申请开始时间	投资账户选择申请时间
投资账户转换申请时间	投资账户转换申请时间
投资账户转换什么时候可以申请	投资账户转换申请时间
投资账户转换申请开始时间	投资账户转换申请时间
终止保险合同申请时间	终止保险合同申请时间
终止保险合同什么时候可以申请	终止保险合同申请时间
终止保险合同申请开始时间	终止保险合同申请时间
申请定期额外投资申请时间	申请定期额外投资申请时间
申请定期额外投资什么时候可以申请	申请定期额外投资申请时间
申请定期额外投资申请开始时间	申请定期额外投资申请时间
变更定期额外投资申请时间	变更定期额外投资申请时间
变更定期额外投资什么时候可以申请	变更定期额外投资申请时间
变更定期额外投资申请开始时间	变更定期额外投资申请时间
终止定期额外投资申请时间	终止定期额外投资申请时间
终止定期额外投资什么时候可以申请	终止定期额外投资申请时间
终止定期额外投资申请开始时间	终止定期额外投资申请时间
犹豫期减保申请时间	犹豫期减保申请时间
犹豫期减保什么时候可以申请	犹豫期减保申请时间
犹豫期减保申请开始时间	犹豫期减保申请时间
犹豫期终止合同申请时间	犹豫期终止合同申请时间
犹豫期终止合同什么时候可以申请	犹豫期终止合同申请时间
犹豫期终止合同申请开始时间	犹豫期终止合同申请时间
犹豫期其他保全变更申请时间	犹豫期其他保全变更申请时间
犹豫期其他保全变更什么时候可以申请	犹豫期其他保全变更申请时间
犹豫期其他保全变更申请开始时间	犹豫期其他保全变更申请时间
补发保单申请时间	补发保单申请时间
补发保单什么时候可以申请	补发保单申请时间
补发保单申请开始时间	补发保单申请时间
尊享惠康支持哪些保全	保险产品支持保全项
尊享惠康保全哪些项目	保险产品支持保全项
尊享惠康投保之后可以修改什么	保险产品支持保全项
尊享惠康投保之后可以修改什么	保险产品支持保全项
尊享惠康投保之后修改什么	保险产品支持保全项
百万信天游支持哪些保全	保险产品支持保全项
百万信天游保全哪些项目	保险产品支持保全项
百万信天游投保之后可以修改什么	保险产品支持保全项
百万信天游投保之后可以修改什么	保险产品支持保全项
百万信天游投保之后修改什么	保险产品支持保全项
康爱保支持哪些保全	保险产品支持保全项
康爱保保全哪些项目	保险产品支持保全项
康爱保投保之后可以修改什么	保险产品支持保全项
康爱保投保之后可以修改什么	保险产品支持保全项
康爱保投保之后修改什么	保险产品支持保全项
全民无忧支持哪些保全	保险产品支持保全项
全民无忧保全哪些项目	保险产品支持保全项
全民无忧投保之后可以修改什么	保险产品支持保全项
全民无忧投保之后可以修改什么	保险产品支持保全项
全民无忧投保之后修改什么	保险产品支持保全项
尊享惠康变更通讯资料保全范围	保险产品变更通讯资料的范围
趸缴可以支持尊享惠康变更通讯资料	保险产品变更通讯资料的范围
期缴可以支持尊享惠康变更通讯资料	保险产品变更通讯资料的范围
年缴可以支持尊享惠康变更通讯资料	保险产品变更通讯资料的范围
月缴可以支持尊享惠康变更通讯资料	保险产品变更通讯资料的范围
尊享惠康银行转账授权保全范围	保险产品银行转账授权的范围
趸缴可以支持尊享惠康银行转账授权	保险产品银行转账授权的范围
期缴可以支持尊享惠康银行转账授权	保险产品银行转账授权的范围
年缴可以支持尊享惠康银行转账授权	保险产品银行转账授权的范围
月缴可以支持尊享惠康银行转账授权	保险产品银行转账授权的范围
尊享惠康更改个人身份资料保全范围	保险产品更改个人身份资料的范围
趸缴可以支持尊享惠康更改个人身份资料	保险产品更改个人身份资料的范围
期缴可以支持尊享惠康更改个人身份资料	保险产品更改个人身份资料的范围
年缴可以支持尊享惠康更改个人身份资料	保险产品更改个人身份资料的范围
月缴可以支持尊享惠康更改个人身份资料	保险产品更改个人身份资料的范围
尊享惠康变更签名保全范围	保险产品变更签名的范围
趸缴可以支持尊享惠康变更签名	保险产品变更签名的范围
期缴可以支持尊享惠康变更签名	保险产品变更签名的范围
年缴可以支持尊享惠康变更签名	保险产品变更签名的范围
月缴可以支持尊享惠康变更签名	保险产品变更签名的范围
尊享惠康变更受益人保全范围	保险产品变更受益人的范围
趸缴可以支持尊享惠康变更受益人	保险产品变更受益人的范围
期缴可以支持尊享惠康变更受益人	保险产品变更受益人的范围
年缴可以支持尊享惠康变更受益人	保险产品变更受益人的范围
月缴可以支持尊享惠康变更受益人	保险产品变更受益人的范围
尊享惠康变更投保人保全范围	保险产品变更投保人的范围
趸缴可以支持尊享惠康变更投保人	保险产品变更投保人的范围
期缴可以支持尊享惠康变更投保人	保险产品变更投保人的范围
年缴可以支持尊享惠康变更投保人	保险产品变更投保人的范围
月缴可以支持尊享惠康变更投保人	保险产品变更投保人的范围
尊享惠康保费逾期未付选择保全范围	保险产品保费逾期未付选择的范围
趸缴可以支持尊享惠康保费逾期未付选择	保险产品保费逾期未付选择的范围
期缴可以支持尊享惠康保费逾期未付选择	保险产品保费逾期未付选择的范围
年缴可以支持尊享惠康保费逾期未付选择	保险产品保费逾期未付选择的范围
月缴可以支持尊享惠康保费逾期未付选择	保险产品保费逾期未付选择的范围
尊享惠康补发保单保全范围	保险产品补发保单的范围
趸缴可以支持尊享惠康补发保单	保险产品补发保单的范围
期缴可以支持尊享惠康补发保单	保险产品补发保单的范围
年缴可以支持尊享惠康补发保单	保险产品补发保单的范围
月缴可以支持尊享惠康补发保单	保险产品补发保单的范围
尊享惠康变更职业等级保全范围	保险产品变更职业等级的范围
趸缴可以支持尊享惠康变更职业等级	保险产品变更职业等级的范围
期缴可以支持尊享惠康变更职业等级	保险产品变更职业等级的范围
年缴可以支持尊享惠康变更职业等级	保险产品变更职业等级的范围
月缴可以支持尊享惠康变更职业等级	保险产品变更职业等级的范围
尊享惠康变更缴费方式保全范围	保险产品变更缴费方式的范围
趸缴可以支持尊享惠康变更缴费方式	保险产品变更缴费方式的范围
期缴可以支持尊享惠康变更缴费方式	保险产品变更缴费方式的范围
年缴可以支持尊享惠康变更缴费方式	保险产品变更缴费方式的范围
月缴可以支持尊享惠康变更缴费方式	保险产品变更缴费方式的范围
尊享惠康变更保险计划保全范围	保险产品变更保险计划的范围
趸缴可以支持尊享惠康变更保险计划	保险产品变更保险计划的范围
期缴可以支持尊享惠康变更保险计划	保险产品变更保险计划的范围
年缴可以支持尊享惠康变更保险计划	保险产品变更保险计划的范围
月缴可以支持尊享惠康变更保险计划	保险产品变更保险计划的范围
尊享惠康复效保全范围	保险产品复效的范围
趸缴可以支持尊享惠康复效	保险产品复效的范围
期缴可以支持尊享惠康复效	保险产品复效的范围
年缴可以支持尊享惠康复效	保险产品复效的范围
月缴可以支持尊享惠康复效	保险产品复效的范围
尊享惠康减额缴清保全范围	保险产品减额缴清的范围
趸缴可以支持尊享惠康减额缴清	保险产品减额缴清的范围
期缴可以支持尊享惠康减额缴清	保险产品减额缴清的范围
年缴可以支持尊享惠康减额缴清	保险产品减额缴清的范围
月缴可以支持尊享惠康减额缴清	保险产品减额缴清的范围
尊享惠康取消承保条件保全范围	保险产品取消承保条件的范围
趸缴可以支持尊享惠康取消承保条件	保险产品取消承保条件的范围
期缴可以支持尊享惠康取消承保条件	保险产品取消承保条件的范围
年缴可以支持尊享惠康取消承保条件	保险产品取消承保条件的范围
月缴可以支持尊享惠康取消承保条件	保险产品取消承保条件的范围
尊享惠康补充告知保全范围	保险产品补充告知的范围
趸缴可以支持尊享惠康补充告知	保险产品补充告知的范围
期缴可以支持尊享惠康补充告知	保险产品补充告知的范围
年缴可以支持尊享惠康补充告知	保险产品补充告知的范围
月缴可以支持尊享惠康补充告知	保险产品补充告知的范围
尊享惠康保单借款保全范围	保险产品保单借款的范围
趸缴可以支持尊享惠康保单借款	保险产品保单借款的范围
期缴可以支持尊享惠康保单借款	保险产品保单借款的范围
年缴可以支持尊享惠康保单借款	保险产品保单借款的范围
月缴可以支持尊享惠康保单借款	保险产品保单借款的范围
尊享惠康保单还款保全范围	保险产品保单还款的范围
趸缴可以支持尊享惠康保单还款	保险产品保单还款的范围
期缴可以支持尊享惠康保单还款	保险产品保单还款的范围
年缴可以支持尊享惠康保单还款	保险产品保单还款的范围
月缴可以支持尊享惠康保单还款	保险产品保单还款的范围
尊享惠康终止保险合同保全范围	保险产品终止保险合同的范围
趸缴可以支持尊享惠康终止保险合同	保险产品终止保险合同的范围
期缴可以支持尊享惠康终止保险合同	保险产品终止保险合同的范围
年缴可以支持尊享惠康终止保险合同	保险产品终止保险合同的范围
月缴可以支持尊享惠康终止保险合同	保险产品终止保险合同的范围
百万信天游变更通讯资料保全范围	保险产品变更通讯资料的范围
趸缴可以支持百万信天游变更通讯资料	保险产品变更通讯资料的范围
期缴可以支持百万信天游变更通讯资料	保险产品变更通讯资料的范围
年缴可以支持百万信天游变更通讯资料	保险产品变更通讯资料的范围
月缴可以支持百万信天游变更通讯资料	保险产品变更通讯资料的范围
百万信天游银行转账授权保全范围	保险产品银行转账授权的范围
趸缴可以支持百万信天游银行转账授权	保险产品银行转账授权的范围
期缴可以支持百万信天游银行转账授权	保险产品银行转账授权的范围
年缴可以支持百万信天游银行转账授权	保险产品银行转账授权的范围
月缴可以支持百万信天游银行转账授权	保险产品银行转账授权的范围
百万信天游更改个人身份资料保全范围	保险产品更改个人身份资料的范围
趸缴可以支持百万信天游更改个人身份资料	保险产品更改个人身份资料的范围
期缴可以支持百万信天游更改个人身份资料	保险产品更改个人身份资料的范围
年缴可以支持百万信天游更改个人身份资料	保险产品更改个人身份资料的范围
月缴可以支持百万信天游更改个人身份资料	保险产品更改个人身份资料的范围
百万信天游变更签名保全范围	保险产品变更签名的范围
趸缴可以支持百万信天游变更签名	保险产品变更签名的范围
期缴可以支持百万信天游变更签名	保险产品变更签名的范围
年缴可以支持百万信天游变更签名	保险产品变更签名的范围
月缴可以支持百万信天游变更签名	保险产品变更签名的范围
百万信天游变更受益人保全范围	保险产品变更受益人的范围
趸缴可以支持百万信天游变更受益人	保险产品变更受益人的范围
期缴可以支持百万信天游变更受益人	保险产品变更受益人的范围
年缴可以支持百万信天游变更受益人	保险产品变更受益人的范围
月缴可以支持百万信天游变更受益人	保险产品变更受益人的范围
百万信天游变更投保人保全范围	保险产品变更投保人的范围
趸缴可以支持百万信天游变更投保人	保险产品变更投保人的范围
期缴可以支持百万信天游变更投保人	保险产品变更投保人的范围
年缴可以支持百万信天游变更投保人	保险产品变更投保人的范围
月缴可以支持百万信天游变更投保人	保险产品变更投保人的范围
百万信天游保费逾期未付选择保全范围	保险产品保费逾期未付选择的范围
趸缴可以支持百万信天游保费逾期未付选择	保险产品保费逾期未付选择的范围
期缴可以支持百万信天游保费逾期未付选择	保险产品保费逾期未付选择的范围
年缴可以支持百万信天游保费逾期未付选择	保险产品保费逾期未付选择的范围
月缴可以支持百万信天游保费逾期未付选择	保险产品保费逾期未付选择的范围
百万信天游补发保单保全范围	保险产品补发保单的范围
趸缴可以支持百万信天游补发保单	保险产品补发保单的范围
期缴可以支持百万信天游补发保单	保险产品补发保单的范围
年缴可以支持百万信天游补发保单	保险产品补发保单的范围
月缴可以支持百万信天游补发保单	保险产品补发保单的范围
百万信天游变更职业等级保全范围	保险产品变更职业等级的范围
趸缴可以支持百万信天游变更职业等级	保险产品变更职业等级的范围
期缴可以支持百万信天游变更职业等级	保险产品变更职业等级的范围
年缴可以支持百万信天游变更职业等级	保险产品变更职业等级的范围
月缴可以支持百万信天游变更职业等级	保险产品变更职业等级的范围
百万信天游变更缴费方式保全范围	保险产品变更缴费方式的范围
趸缴可以支持百万信天游变更缴费方式	保险产品变更缴费方式的范围
期缴可以支持百万信天游变更缴费方式	保险产品变更缴费方式的范围
年缴可以支持百万信天游变更缴费方式	保险产品变更缴费方式的范围
月缴可以支持百万信天游变更缴费方式	保险产品变更缴费方式的范围
百万信天游附约变更保全范围	保险产品附约变更的范围
趸缴可以支持百万信天游附约变更	保险产品附约变更的范围
期缴可以支持百万信天游附约变更	保险产品附约变更的范围
年缴可以支持百万信天游附约变更	保险产品附约变更的范围
月缴可以支持百万信天游附约变更	保险产品附约变更的范围
百万信天游复效保全范围	保险产品复效的范围
趸缴可以支持百万信天游复效	保险产品复效的范围
期缴可以支持百万信天游复效	保险产品复效的范围
年缴可以支持百万信天游复效	保险产品复效的范围
月缴可以支持百万信天游复效	保险产品复效的范围
百万信天游取消承保条件保全范围	保险产品取消承保条件的范围
趸缴可以支持百万信天游取消承保条件	保险产品取消承保条件的范围
期缴可以支持百万信天游取消承保条件	保险产品取消承保条件的范围
年缴可以支持百万信天游取消承保条件	保险产品取消承保条件的范围
月缴可以支持百万信天游取消承保条件	保险产品取消承保条件的范围
百万信天游补充告知保全范围	保险产品补充告知的范围
趸缴可以支持百万信天游补充告知	保险产品补充告知的范围
期缴可以支持百万信天游补充告知	保险产品补充告知的范围
年缴可以支持百万信天游补充告知	保险产品补充告知的范围
月缴可以支持百万信天游补充告知	保险产品补充告知的范围
百万信天游保单借款保全范围	保险产品保单借款的范围
趸缴可以支持百万信天游保单借款	保险产品保单借款的范围
期缴可以支持百万信天游保单借款	保险产品保单借款的范围
年缴可以支持百万信天游保单借款	保险产品保单借款的范围
月缴可以支持百万信天游保单借款	保险产品保单借款的范围
百万信天游保单还款保全范围	保险产品保单还款的范围
趸缴可以支持百万信天游保单还款	保险产品保单还款的范围
期缴可以支持百万信天游保单还款	保险产品保单还款的范围
年缴可以支持百万信天游保单还款	保险产品保单还款的范围
月缴可以支持百万信天游保单还款	保险产品保单还款的范围
百万信天游满期生存确认保全范围	保险产品满期生存确认的范围
趸缴可以支持百万信天游满期生存确认	保险产品满期生存确认的范围
期缴可以支持百万信天游满期生存确认	保险产品满期生存确认的范围
年缴可以支持百万信天游满期生存确认	保险产品满期生存确认的范围
月缴可以支持百万信天游满期生存确认	保险产品满期生存确认的范围
百万信天游终止保险合同保全范围	保险产品终止保险合同的范围
趸缴可以支持百万信天游终止保险合同	保险产品终止保险合同的范围
期缴可以支持百万信天游终止保险合同	保险产品终止保险合同的范围
年缴可以支持百万信天游终止保险合同	保险产品终止保险合同的范围
月缴可以支持百万信天游终止保险合同	保险产品终止保险合同的范围
康爱保变更通讯资料保全范围	保险产品变更通讯资料的范围
趸缴可以支持康爱保变更通讯资料	保险产品变更通讯资料的范围
期缴可以支持康爱保变更通讯资料	保险产品变更通讯资料的范围
年缴可以支持康爱保变更通讯资料	保险产品变更通讯资料的范围
月缴可以支持康爱保变更通讯资料	保险产品变更通讯资料的范围
康爱保银行转账授权保全范围	保险产品银行转账授权的范围
趸缴可以支持康爱保银行转账授权	保险产品银行转账授权的范围
期缴可以支持康爱保银行转账授权	保险产品银行转账授权的范围
年缴可以支持康爱保银行转账授权	保险产品银行转账授权的范围
月缴可以支持康爱保银行转账授权	保险产品银行转账授权的范围
康爱保更改个人身份资料保全范围	保险产品更改个人身份资料的范围
趸缴可以支持康爱保更改个人身份资料	保险产品更改个人身份资料的范围
期缴可以支持康爱保更改个人身份资料	保险产品更改个人身份资料的范围
年缴可以支持康爱保更改个人身份资料	保险产品更改个人身份资料的范围
月缴可以支持康爱保更改个人身份资料	保险产品更改个人身份资料的范围
康爱保变更签名保全范围	保险产品变更签名的范围
趸缴可以支持康爱保变更签名	保险产品变更签名的范围
期缴可以支持康爱保变更签名	保险产品变更签名的范围
年缴可以支持康爱保变更签名	保险产品变更签名的范围
月缴可以支持康爱保变更签名	保险产品变更签名的范围
康爱保变更受益人保全范围	保险产品变更受益人的范围
趸缴可以支持康爱保变更受益人	保险产品变更受益人的范围
期缴可以支持康爱保变更受益人	保险产品变更受益人的范围
年缴可以支持康爱保变更受益人	保险产品变更受益人的范围
月缴可以支持康爱保变更受益人	保险产品变更受益人的范围
康爱保变更投保人保全范围	保险产品变更投保人的范围
趸缴可以支持康爱保变更投保人	保险产品变更投保人的范围
期缴可以支持康爱保变更投保人	保险产品变更投保人的范围
年缴可以支持康爱保变更投保人	保险产品变更投保人的范围
月缴可以支持康爱保变更投保人	保险产品变更投保人的范围
康爱保保费逾期未付选择保全范围	保险产品保费逾期未付选择的范围
趸缴可以支持康爱保保费逾期未付选择	保险产品保费逾期未付选择的范围
期缴可以支持康爱保保费逾期未付选择	保险产品保费逾期未付选择的范围
年缴可以支持康爱保保费逾期未付选择	保险产品保费逾期未付选择的范围
月缴可以支持康爱保保费逾期未付选择	保险产品保费逾期未付选择的范围
康爱保补发保单保全范围	保险产品补发保单的范围
趸缴可以支持康爱保补发保单	保险产品补发保单的范围
期缴可以支持康爱保补发保单	保险产品补发保单的范围
年缴可以支持康爱保补发保单	保险产品补发保单的范围
月缴可以支持康爱保补发保单	保险产品补发保单的范围
康爱保变更职业等级保全范围	保险产品变更职业等级的范围
趸缴可以支持康爱保变更职业等级	保险产品变更职业等级的范围
期缴可以支持康爱保变更职业等级	保险产品变更职业等级的范围
年缴可以支持康爱保变更职业等级	保险产品变更职业等级的范围
月缴可以支持康爱保变更职业等级	保险产品变更职业等级的范围
康爱保变更缴费方式保全范围	保险产品变更缴费方式的范围
趸缴可以支持康爱保变更缴费方式	保险产品变更缴费方式的范围
期缴可以支持康爱保变更缴费方式	保险产品变更缴费方式的范围
年缴可以支持康爱保变更缴费方式	保险产品变更缴费方式的范围
月缴可以支持康爱保变更缴费方式	保险产品变更缴费方式的范围
康爱保降低主险保额保全范围	保险产品降低主险保额的范围
趸缴可以支持康爱保降低主险保额	保险产品降低主险保额的范围
期缴可以支持康爱保降低主险保额	保险产品降低主险保额的范围
年缴可以支持康爱保降低主险保额	保险产品降低主险保额的范围
月缴可以支持康爱保降低主险保额	保险产品降低主险保额的范围
康爱保复效保全范围	保险产品复效的范围
趸缴可以支持康爱保复效	保险产品复效的范围
期缴可以支持康爱保复效	保险产品复效的范围
年缴可以支持康爱保复效	保险产品复效的范围
月缴可以支持康爱保复效	保险产品复效的范围
康爱保取消承保条件保全范围	保险产品取消承保条件的范围
趸缴可以支持康爱保取消承保条件	保险产品取消承保条件的范围
期缴可以支持康爱保取消承保条件	保险产品取消承保条件的范围
年缴可以支持康爱保取消承保条件	保险产品取消承保条件的范围
月缴可以支持康爱保取消承保条件	保险产品取消承保条件的范围
康爱保补充告知保全范围	保险产品补充告知的范围
趸缴可以支持康爱保补充告知	保险产品补充告知的范围
期缴可以支持康爱保补充告知	保险产品补充告知的范围
年缴可以支持康爱保补充告知	保险产品补充告知的范围
月缴可以支持康爱保补充告知	保险产品补充告知的范围
康爱保保单借款保全范围	保险产品保单借款的范围
趸缴可以支持康爱保保单借款	保险产品保单借款的范围
期缴可以支持康爱保保单借款	保险产品保单借款的范围
年缴可以支持康爱保保单借款	保险产品保单借款的范围
月缴可以支持康爱保保单借款	保险产品保单借款的范围
康爱保保单还款保全范围	保险产品保单还款的范围
趸缴可以支持康爱保保单还款	保险产品保单还款的范围
期缴可以支持康爱保保单还款	保险产品保单还款的范围
年缴可以支持康爱保保单还款	保险产品保单还款的范围
月缴可以支持康爱保保单还款	保险产品保单还款的范围
康爱保终止保险合同保全范围	保险产品终止保险合同的范围
趸缴可以支持康爱保终止保险合同	保险产品终止保险合同的范围
期缴可以支持康爱保终止保险合同	保险产品终止保险合同的范围
年缴可以支持康爱保终止保险合同	保险产品终止保险合同的范围
月缴可以支持康爱保终止保险合同	保险产品终止保险合同的范围
全民无忧变更通讯资料保全范围	保险产品变更通讯资料的范围
趸缴可以支持全民无忧变更通讯资料	保险产品变更通讯资料的范围
期缴可以支持全民无忧变更通讯资料	保险产品变更通讯资料的范围
年缴可以支持全民无忧变更通讯资料	保险产品变更通讯资料的范围
月缴可以支持全民无忧变更通讯资料	保险产品变更通讯资料的范围
全民无忧银行转账授权保全范围	保险产品银行转账授权的范围
趸缴可以支持全民无忧银行转账授权	保险产品银行转账授权的范围
期缴可以支持全民无忧银行转账授权	保险产品银行转账授权的范围
年缴可以支持全民无忧银行转账授权	保险产品银行转账授权的范围
月缴可以支持全民无忧银行转账授权	保险产品银行转账授权的范围
全民无忧变更投保人保全范围	保险产品变更投保人的范围
趸缴可以支持全民无忧变更投保人	保险产品变更投保人的范围
期缴可以支持全民无忧变更投保人	保险产品变更投保人的范围
年缴可以支持全民无忧变更投保人	保险产品变更投保人的范围
月缴可以支持全民无忧变更投保人	保险产品变更投保人的范围
全民无忧更改个人身份资料保全范围	保险产品更改个人身份资料的范围
趸缴可以支持全民无忧更改个人身份资料	保险产品更改个人身份资料的范围
期缴可以支持全民无忧更改个人身份资料	保险产品更改个人身份资料的范围
年缴可以支持全民无忧更改个人身份资料	保险产品更改个人身份资料的范围
月缴可以支持全民无忧更改个人身份资料	保险产品更改个人身份资料的范围
全民无忧变更签名保全范围	保险产品变更签名的范围
趸缴可以支持全民无忧变更签名	保险产品变更签名的范围
期缴可以支持全民无忧变更签名	保险产品变更签名的范围
年缴可以支持全民无忧变更签名	保险产品变更签名的范围
月缴可以支持全民无忧变更签名	保险产品变更签名的范围
全民无忧补发保单保全范围	保险产品补发保单的范围
趸缴可以支持全民无忧补发保单	保险产品补发保单的范围
期缴可以支持全民无忧补发保单	保险产品补发保单的范围
年缴可以支持全民无忧补发保单	保险产品补发保单的范围
月缴可以支持全民无忧补发保单	保险产品补发保单的范围
全民无忧变更缴费方式保全范围	保险产品变更缴费方式的范围
趸缴可以支持全民无忧变更缴费方式	保险产品变更缴费方式的范围
期缴可以支持全民无忧变更缴费方式	保险产品变更缴费方式的范围
年缴可以支持全民无忧变更缴费方式	保险产品变更缴费方式的范围
月缴可以支持全民无忧变更缴费方式	保险产品变更缴费方式的范围
全民无忧变更职业等级保全范围	保险产品变更职业等级的范围
趸缴可以支持全民无忧变更职业等级	保险产品变更职业等级的范围
期缴可以支持全民无忧变更职业等级	保险产品变更职业等级的范围
年缴可以支持全民无忧变更职业等级	保险产品变更职业等级的范围
月缴可以支持全民无忧变更职业等级	保险产品变更职业等级的范围
全民无忧补充告知保全范围	保险产品补充告知的范围
趸缴可以支持全民无忧补充告知	保险产品补充告知的范围
期缴可以支持全民无忧补充告知	保险产品补充告知的范围
年缴可以支持全民无忧补充告知	保险产品补充告知的范围
月缴可以支持全民无忧补充告知	保险产品补充告知的范围
全民无忧取消承保条件保全范围	保险产品取消承保条件的范围
趸缴可以支持全民无忧取消承保条件	保险产品取消承保条件的范围
期缴可以支持全民无忧取消承保条件	保险产品取消承保条件的范围
年缴可以支持全民无忧取消承保条件	保险产品取消承保条件的范围
月缴可以支持全民无忧取消承保条件	保险产品取消承保条件的范围
全民无忧终止保险合同保全范围	保险产品终止保险合同的范围
趸缴可以支持全民无忧终止保险合同	保险产品终止保险合同的范围
期缴可以支持全民无忧终止保险合同	保险产品终止保险合同的范围
年缴可以支持全民无忧终止保险合同	保险产品终止保险合同的范围
月缴可以支持全民无忧终止保险合同	保险产品终止保险合同的范围
心脏病是否赔偿死亡保障金 	 疾病是否赔某个保障项目
心脏病赔不赔死亡保障金 	 疾病是否赔某个保障项目
心脏病赔不赔偿死亡保障金 	 疾病是否赔某个保障项目
死亡保障金心脏病能否赔偿 	 疾病是否赔某个保障项目
死亡保障金心脏病会赔吗 	 疾病是否赔某个保障项目
死亡保障金心脏病可以赔吗 	 疾病是否赔某个保障项目
死亡保障金心脏病会赔的吧 	 疾病是否赔某个保障项目
死亡保障金心脏病不会赔吗 	 疾病是否赔某个保障项目
死亡保障金心脏病要赔吗 	 疾病是否赔某个保障项目
死亡保障金心脏病出事故都会赔偿吗 	 疾病是否赔某个保障项目
死亡保障金心脏病发生有保障吗 	 疾病是否赔某个保障项目
死亡保障金心脏病赔钱吗 	 疾病是否赔某个保障项目
死亡保障金心脏病赔偿吗 	 疾病是否赔某个保障项目
死亡保障金心脏病保不保 	 疾病是否赔某个保障项目
死亡保障金心脏病能赔吗 	 疾病是否赔某个保障项目
死亡保障金心脏病保吗 	 疾病是否赔某个保障项目
死亡保障金心脏病保么 	 疾病是否赔某个保障项目
死亡保障金心脏病能保么 	 疾病是否赔某个保障项目
死亡保障金心脏病能保吗 	 疾病是否赔某个保障项目
得了死亡保障金心脏病能赔偿吗 	 疾病是否赔某个保障项目
死亡保障金使用违禁药品是否赔偿 	 情景是否赔偿某个保障项目
死亡保障金使用违禁药品赔不赔 	 情景是否赔偿某个保障项目
死亡保障金使用违禁药品赔不赔偿 	 情景是否赔偿某个保障项目
死亡保障金使用违禁药品能否赔偿 	 情景是否赔偿某个保障项目
死亡保障金使用违禁药品会赔吗 	 情景是否赔偿某个保障项目
死亡保障金使用违禁药品可以赔吗 	 情景是否赔偿某个保障项目
死亡保障金使用违禁药品会赔的吧 	 情景是否赔偿某个保障项目
死亡保障金使用违禁药品不会赔吗 	 情景是否赔偿某个保障项目
死亡保障金使用违禁药品要赔吗 	 情景是否赔偿某个保障项目
死亡保障金使用违禁药品出事故都会赔偿吗 	 情景是否赔偿某个保障项目
死亡保障金使用违禁药品发生有保障吗 	 情景是否赔偿某个保障项目
死亡保障金使用违禁药品赔钱吗 	 情景是否赔偿某个保障项目
死亡保障金使用违禁药品赔偿吗 	 情景是否赔偿某个保障项目
死亡保障金使用违禁药品保不保 	 情景是否赔偿某个保障项目
死亡保障金使用违禁药品能赔吗 	 情景是否赔偿某个保障项目
死亡保障金使用违禁药品保吗 	 情景是否赔偿某个保障项目
死亡保障金使用违禁药品保么 	 情景是否赔偿某个保障项目
死亡保障金使用违禁药品能保么 	 情景是否赔偿某个保障项目
死亡保障金使用违禁药品能保吗 	 情景是否赔偿某个保障项目
心脏病是否赔偿 	 某种疾病是否在承保范围内
心脏病赔不赔 	 某种疾病是否在承保范围内
心脏病赔不赔偿 	 某种疾病是否在承保范围内
心脏病能否赔偿 	 某种疾病是否在承保范围内
心脏病会赔吗 	 某种疾病是否在承保范围内
心脏病可以赔吗 	 某种疾病是否在承保范围内
心脏病会赔的吧 	 某种疾病是否在承保范围内
心脏病不会赔吗 	 某种疾病是否在承保范围内
心脏病要赔吗 	 某种疾病是否在承保范围内
心脏病出事故都会赔偿吗 	 某种疾病是否在承保范围内
心脏病发生有保障吗 	 某种疾病是否在承保范围内
心脏病赔钱吗 	 某种疾病是否在承保范围内
心脏病赔偿吗 	 某种疾病是否在承保范围内
心脏病保不保 	 某种疾病是否在承保范围内
心脏病能赔吗 	 某种疾病是否在承保范围内
心脏病保吗 	 某种疾病是否在承保范围内
心脏病保么 	 某种疾病是否在承保范围内
心脏病能保么 	 某种疾病是否在承保范围内
心脏病能保吗 	 某种疾病是否在承保范围内
得了心脏病能赔偿吗 	 某种疾病是否在承保范围内
使用违禁药品是否赔偿 	 某情景是否在承保范围内
使用违禁药品赔不赔 	 某情景是否在承保范围内
使用违禁药品赔不赔偿 	 某情景是否在承保范围内
使用违禁药品能否赔偿 	 某情景是否在承保范围内
使用违禁药品会赔吗 	 某情景是否在承保范围内
使用违禁药品可以赔吗 	 某情景是否在承保范围内
使用违禁药品会赔的吧 	 某情景是否在承保范围内
使用违禁药品不会赔吗 	 某情景是否在承保范围内
使用违禁药品要赔吗 	 某情景是否在承保范围内
使用违禁药品出事故都会赔偿吗 	 某情景是否在承保范围内
使用违禁药品发生有保障吗 	 某情景是否在承保范围内
使用违禁药品赔钱吗 	 某情景是否在承保范围内
使用违禁药品赔偿吗 	 某情景是否在承保范围内
使用违禁药品保不保 	 某情景是否在承保范围内
使用违禁药品能赔吗 	 某情景是否在承保范围内
使用违禁药品保吗 	 某情景是否在承保范围内
使用违禁药品保么 	 某情景是否在承保范围内
使用违禁药品能保吗 	 某情景是否在承保范围内
重症疾病定义 	 疾病种类的定义
重症疾病是什么 	 疾病种类的定义
重症疾病什么意思 	 疾病种类的定义
哪些算是重症疾病 	 疾病种类包含哪些疾病
解释一下重症疾病 	 疾病种类的定义
重症疾病是啥 	 疾病种类的定义
重症疾病定义 	 疾病种类的定义
什么是重症疾病 	 疾病种类的定义
重症疾病含义 	 疾病种类的定义
重症疾病不知道是啥 	 疾病种类的定义
重症疾病干什么用的 	 疾病种类的定义
重症疾病有什么用 	 疾病种类的定义
重症疾病是多少 	 疾病种类的定义
重症疾病啥意思 	 疾病种类的定义
重症疾病是指什么 	 疾病种类的定义
什么算重症疾病 	 疾病种类的定义
我想了解一下重症疾病 	 疾病种类的定义
重症疾病是怎么定义的 	 疾病种类的定义
重症疾病的官方说法 	 疾病种类的定义
重症疾病的官方解释 	 疾病种类的定义
重症疾病具体是怎么回事 	 疾病种类的定义
重症疾病的释义 	 疾病种类的定义
重症疾病怎么理解 	 疾病种类的定义
死亡保障金定义 	 保障项目的定义
死亡保障金是什么 	 保障项目的定义
死亡保障金什么意思 	 保障项目的定义
哪些算是死亡保障金 	 保障项目的定义
解释一下死亡保障金 	 保障项目的定义
死亡保障金是啥 	 保障项目的定义
死亡保障金定义 	 保障项目的定义
什么是死亡保障金 	 保障项目的定义
死亡保障金含义 	 保障项目的定义
死亡保障金不知道是啥 	 保障项目的定义
死亡保障金干什么用的 	 保障项目的定义
死亡保障金有什么用 	 保障项目的定义
死亡保障金是多少 	 保障项目的定义
死亡保障金啥意思 	 保障项目的定义
死亡保障金是指什么 	 保障项目的定义
什么算死亡保障金 	 保障项目的定义
我想了解一下死亡保障金 	 保障项目的定义
死亡保障金是怎么定义的 	 保障项目的定义
死亡保障金的官方说法 	 保障项目的定义
死亡保障金的官方解释 	 保障项目的定义
死亡保障金具体是怎么回事 	 保障项目的定义
死亡保障金的释义 	 保障项目的定义
死亡保障金怎么理解 	 保障项目的定义
使用违禁药品定义 	 情景的定义
使用违禁药品是什么 	 情景的定义
使用违禁药品什么意思 	 情景的定义
哪些算是使用违禁药品 	 情景的定义
解释一下使用违禁药品 	 情景的定义
使用违禁药品是啥 	 情景的定义
使用违禁药品定义 	 情景的定义
什么是使用违禁药品 	 情景的定义
使用违禁药品含义 	 情景的定义
使用违禁药品不知道是啥 	 情景的定义
使用违禁药品干什么用的 	 情景的定义
使用违禁药品有什么用 	 情景的定义
使用违禁药品是多少 	 情景的定义
使用违禁药品啥意思 	 情景的定义
使用违禁药品是指什么 	 情景的定义
什么算使用违禁药品 	 情景的定义
我想了解一下使用违禁药品 	 情景的定义
使用违禁药品是怎么定义的 	 情景的定义
使用违禁药品的官方说法 	 情景的定义
使用违禁药品的官方解释 	 情景的定义
使用违禁药品具体是怎么回事 	 情景的定义
使用违禁药品的释义 	 情景的定义
使用违禁药品怎么理解 	 情景的定义
心脏病定义 	 疾病的定义
心脏病是什么 	 疾病的定义
心脏病什么意思 	 疾病的定义
哪些算是心脏病 	 疾病的定义
解释一下心脏病 	 疾病的定义
心脏病是啥 	 疾病的定义
心脏病定义 	 疾病的定义
什么是心脏病 	 疾病的定义
心脏病含义 	 疾病的定义
心脏病不知道是啥 	 疾病的定义
心脏病干什么用的 	 疾病的定义
心脏病有什么用 	 疾病的定义
心脏病是多少 	 疾病的定义
心脏病啥意思 	 疾病的定义
心脏病是指什么 	 疾病的定义
什么算心脏病 	 疾病的定义
我想了解一下心脏病 	 疾病的定义
心脏病是怎么定义的 	 疾病的定义
心脏病的官方说法 	 疾病的定义
心脏病的官方解释 	 疾病的定义
心脏病的官方解释 	 疾病的定义
心脏病具体是怎么回事 	 疾病的定义
心脏病的释义 	 疾病的定义
心脏病怎么理解 	 疾病的定义
医学必要定义 	 释义项的定义
医学必要是什么 	 释义项的定义
医学必要什么意思 	 释义项的定义
哪些算是医学必要 	 释义项的定义
解释一下医学必要 	 释义项的定义
医学必要是啥 	 释义项的定义
医学必要定义 	 释义项的定义
什么是医学必要 	 释义项的定义
医学必要含义 	 释义项的定义
医学必要不知道是啥 	 释义项的定义
医学必要干什么用的 	 释义项的定义
医学必要有什么用 	 释义项的定义
医学必要是多少 	 释义项的定义
医学必要啥意思 	 释义项的定义
医学必要是指什么 	 释义项的定义
什么算医学必要 	 释义项的定义
关于医学必要 	 释义项的定义
医学必要治疗费用是包括了哪些 	 释义项的定义
我想了解一下医学必要 	 释义项的定义
医学必要是怎么定义的 	 释义项的定义
医学必要的官方说法 	 释义项的定义
医学必要的官方解释 	 释义项的定义
医学必要的官方解释 	 释义项的定义
医学必要具体是怎么回事 	 释义项的定义
医学必要的释义 	 释义项的定义
医学必要怎么理解 	 释义项的定义
定义 	 保险产品的定义
是什么 	 保险产品的定义
什么意思 	 保险产品的定义
解释一下 	 保险产品的定义
是啥 	 保险产品的定义
定义 	 保险产品的定义
什么是 	 保险产品的定义
含义 	 保险产品的定义
不知道是啥 	 保险产品的定义
干什么用的 	 保险产品的定义
有什么用 	 保险产品的定义
啥意思 	 保险产品的定义
是指什么 	 保险产品的定义
什么算 	 保险产品的定义
能介绍下吗 	 保险产品的定义
介绍一下 	 保险产品的定义
我想了解一下 	 保险产品的定义
我想买 	 保险产品的定义
是怎么定义的 	 保险产品的定义
的官方说法 	 保险产品的定义
的官方解释 	 保险产品的定义
的官方解释 	 保险产品的定义
具体是怎么回事 	 保险产品的定义
的释义 	 保险产品的定义
怎么理解 	 保险产品的定义
是用来做什么的 	 保险产品的定义
死亡保障金责任免除 	 保障项目的责任免除详情
死亡保障金什么是责任免除 	 保障项目的责任免除详情
死亡保障金哪些情况不赔偿 	 保障项目的责任免除详情
死亡保障金不赔的情况哪些 	 保障项目的责任免除详情
死亡保障金存在不赔偿的情况吗 	 保障项目的责任免除详情
死亡保障金有没有不赔偿的情况呢 	 保障项目的责任免除详情
死亡保障金责任免除对我有什么用 	 保障项目的责任免除详情
死亡保障金什么情况下不保 	 保障项目的责任免除详情
死亡保障金不保有哪些情况 	 保障项目的责任免除详情
死亡保障金不赔偿的哪些 	 保障项目的责任免除详情
死亡保障金什么情况下不承担 	 保障项目的责任免除详情
死亡保障金哪些情况是免赔 	 保障项目的责任免除详情
死亡保障金有什么情况是不能申请理赔的 	 保障项目的责任免除详情
死亡保障金不保什么 	 保障项目的责任免除详情
死亡保障金不保什么 	 保障项目的责任免除详情
死亡保障金什么情况下免责 	 保障项目的责任免除详情
死亡保障金有没有责任免除项 	 保障项目的责任免除详情
死亡保障金责任免除都有什么 	 保障项目的责任免除详情
死亡保障金责任免除的都不赔吗 	 保障项目的责任免除详情
死亡保障金责任免除内容 	 保障项目的责任免除详情
死亡保障金不保什么 	 保障项目的责任免除详情
死亡保障金不保的内容 	 保障项目的责任免除详情
死亡保障金有什么不保的 	 保障项目的责任免除详情
死亡保障金不保的范围 	 保障项目的责任免除详情
死亡保障金除外责任 	 保障项目的责任免除详情
死亡保障金免责条款 	 询问免责条款
死亡保障金免责内容有哪几项 	 询问免责条款
请问死亡保障金哪些情况不保 	 保障项目的责任免除详情
死亡保障金哪些情况不保 	 保障项目的责任免除详情
死亡保障金哪些情况不在承保范围内 	 保障项目的责任免除详情
死亡保障金不保的情况有哪些 	 保障项目的责任免除详情
死亡保障金哪些情况不属于保障范围 	 保障项目的责任免除详情
死亡保障金哪些情况保险公司不承担赔付责任 	 保障项目的责任免除详情
死亡保障金有没有什么免责条款 	 询问免责条款
合同变更 	 询问合同变更
如何变更合同 	 询问合同变更
我想变更合同 	 询问合同变更
我想更改合同 	 询问合同变更
合同变更对被保险人年龄有什么要求吗 	 询问合同变更
申请减少基本保险金额有什么条件吗 	 询问合同变更
变更合同可以更改保险金额吗 	 询问合同变更
合同要怎样可以变更 	 询问合同变更
变更合同流程 	 询问合同变更
变更合同指南 	 询问合同变更
我需要变更合同 	 询问合同变更
合同变更是什么签完 	 询问合同变更
合同什么时候保单开始生效 	 询问合同变更
死亡保障金理赔申请 	 保障项目如何申请理赔
死亡保障金怎么申请理赔 	 保障项目如何申请理赔
死亡保障金如何理赔 	 保障项目如何申请理赔
死亡保障金申请理赔需要准备什么 	 保障项目如何申请理赔
死亡保障金保后理赔流程是如何的 	 保障项目如何申请理赔
死亡保障金申领应该注意什么 	 保障项目如何申请理赔
死亡保障金航班延误保险索赔要提供啥 	 保障项目如何申请理赔
死亡保障金可以用身份证申请理赔吗 	 保障项目如何申请理赔
死亡保障金保险单丢了影响赔付吗 	 保障项目如何申请理赔
死亡保障金索赔要提供啥 	 保障项目如何申请理赔
死亡保障金赔偿处理需要什么资料 	 保障项目如何申请理赔
死亡保障金机票丢了还能申请理赔吗 	 保障项目如何申请理赔
死亡保障金申请理赔需要的材料 	 保障项目如何申请理赔
死亡保障金航班延误保险我要赔偿需要提供什么材料啊 	 保障项目如何申请理赔
死亡保障金我要赔偿需要提供什么材料啊 	 保障项目如何申请理赔
死亡保障金索赔要提供什么材料 	 保障项目如何申请理赔
死亡保障金赔偿要什么材料 	 保障项目如何申请理赔
死亡保障金赔偿要哪些材料 	 保障项目如何申请理赔
死亡保障金保险金申请 	 保障项目如何申请理赔
死亡保障金赔偿怎么处理 	 保障项目如何申请理赔
死亡保障金保险金怎么申请 	 保障项目如何申请理赔
死亡保障金怎么赔偿 	 保障项目如何申请理赔
死亡保障金航班延误保险索赔的流程 	 保障项目如何申请理赔
死亡保障金航班延误保险索赔申请指南 	 保障项目如何申请理赔
死亡保障金航班延误保险索赔申请的注意事项 	 保障项目如何申请理赔
死亡保障金航班延误保险索赔一定要提交什么材料呢 	 保障项目如何申请理赔
死亡保障金航班延误险理赔需要提供什么 	 保障项目如何申请理赔
死亡保障金申请索赔需要提交什么 	 保障项目如何申请理赔
死亡保障金航班延误理赔需要提供身份证号码和银行卡号吗 	 保障项目如何申请理赔
死亡保障金不确定航班延误保险索赔要提供什么 	 保障项目如何申请理赔
死亡保障金可以告诉我航班延误保险索赔需要提供什么吗 	 保障项目如何申请理赔
死亡保障金介绍一下航班延误保险索赔需要提供什么 	 保障项目如何申请理赔
死亡保障金飞机延误了，我需要准备什么材料索赔 	 保障项目如何申请理赔
死亡保障金如何理赔？ 	 保障项目如何申请理赔
死亡保障金怎么样去理赔呢 	 保障项目如何申请理赔
死亡保障金理赔有什么方法 	 保障项目如何申请理赔
死亡保障金我想理赔 	 保障项目如何申请理赔
死亡保障金我不知道怎么理赔 	 保障项目如何申请理赔
死亡保障金理赔的流程是什么呢 	 保障项目如何申请理赔
死亡保障金理赔有什么流程呢 	 保障项目如何申请理赔
死亡保障金我想申请理赔 	 保障项目如何申请理赔
死亡保障金我不知道怎么理赔？ 	 保障项目如何申请理赔
死亡保障金能告诉我怎么理赔吗？ 	 保障项目如何申请理赔
死亡保障金理赔该怎么走流程 	 保障项目如何申请理赔
死亡保障金怎样申请理赔？ 	 保障项目如何申请理赔
死亡保障金如何申请理赔？ 	 保障项目如何申请理赔
死亡保障金申请理赔需要怎么做？ 	 保障项目如何申请理赔
死亡保障金我要申请理赔，不知道流程？ 	 保障项目如何申请理赔
死亡保障金可以告诉我怎样申请理赔吗？ 	 保障项目如何申请理赔
死亡保障金请问一下申请理赔需要什么？ 	 保障项目如何申请理赔
死亡保障金理赔材料有哪些？ 	 保障项目如何申请理赔
死亡保障金保险理赔需要哪些材料？ 	 保障项目如何申请理赔
死亡保障金保险理赔需要什么材料? 	 保障项目如何申请理赔
死亡保障金保险的理赔材料都有哪些呢？ 	 保障项目如何申请理赔
死亡保障金什么是保险的理赔材料？ 	 保障项目如何申请理赔
死亡保障金哪些是保险的理赔材料呢？ 	 保障项目如何申请理赔
死亡保障金都有哪些理赔材料呢？ 	 保障项目如何申请理赔
死亡保障金我不知道有什么理赔材料 	 保障项目如何申请理赔
死亡保障金申请理赔，需要提供什么材料呢？ 	 保障项目如何申请理赔
死亡保障金可以告诉我理赔都需要什么材料吗？ 	 保障项目如何申请理赔
死亡保障金我想咨询一下申请理赔需要提前准备什么？ 	 保障项目如何申请理赔
死亡保障金请问一下申请理赔需要什么材料？ 	 保障项目如何申请理赔
死亡保障金我想申请理赔，都有哪些材料需要准备？ 	 保障项目如何申请理赔
死亡保障金我不清楚需要准备什么理赔材料？ 	 保障项目如何申请理赔
死亡保障金索赔需要登机牌吗？ 	 保障项目如何申请理赔
死亡保障金怎么申请索赔 	 保障项目如何申请理赔
死亡保障金我怎么索赔 	 保障项目如何申请理赔
死亡保障金申请理赔需要被保险人的航班订座记录吗 	 保障项目如何申请理赔
死亡保障金申请理赔需要被保险人的保险购买记录吗 	 保障项目如何申请理赔
死亡保障金申请理赔需要被保险人的银行账户信息吗 	 保障项目如何申请理赔
死亡保障金申请理赔需要保险凭证正本吗 	 保障项目如何申请理赔
死亡保障金申请理赔需要保险事故证明文件正本吗 	 保障项目如何申请理赔
死亡保障金申请理赔需要航班凭证的原件吗 	 保障项目如何申请理赔
死亡保障金申请理赔需要授权委托书原件受托人的身份证明等吗 	 保障项目如何申请理赔
死亡保障金申请理赔需要有效保险凭证吗 	 保障项目如何申请理赔
死亡保障金申请理赔需要索赔申请书吗 	 保障项目如何申请理赔
死亡保障金申请理赔需要被保险人的身份证明吗 	 保障项目如何申请理赔
死亡保障金申请理赔需要被保险人的登机证明吗 	 保障项目如何申请理赔
死亡保障金申请理赔需要延误证明吗 	 保障项目如何申请理赔
死亡保障金申请理赔需要航班取消正式书面证明文件吗 	 保障项目如何申请理赔
死亡保障金申请理赔需要延误时间正式书面证明文件吗 	 保障项目如何申请理赔
死亡保障金申请理赔需要证明保险事故原因损失程度的文件资料吗 	 保障项目如何申请理赔
死亡保障金申请理赔需要授权委托书原件委托人和受托人的身份证明吗 	 保障项目如何申请理赔
死亡保障金申请理赔需要航空公司证明吗 	 保障项目如何申请理赔
死亡保障金申请理赔需要被保险人本人的银行账户信息吗 	 保障项目如何申请理赔
死亡保障金没有航空公司的延误证明能否申请保险金 	 保障项目如何申请理赔
死亡保障金保险人怎样领取赔偿金 	 保障项目如何申请理赔
死亡保障金理赔流程 	 保障项目如何申请理赔
死亡保障金发生事故，保险怎么赔 	 保障项目如何申请理赔
死亡保障金发生如何理赔 	 保障项目如何申请理赔
死亡保障金如何赔 	 保障项目如何申请理赔
死亡保障金申请理赔具体的操作是怎么样的 	 保障项目如何申请理赔
死亡保障金满足合同的理赔范围，我要怎么去申请 	 保障项目如何申请理赔
死亡保障金能告诉我申请理赔都要准备些什么东西吗？ 	 保障项目如何申请理赔
死亡保障金要携带什么材料？ 	 保障项目如何申请理赔
死亡保障金保险金怎么领取 	 保障项目如何申请理赔
死亡保障金购买保险需要什么资料 	 保障项目如何申请理赔
如何申领死亡保障金 	 保障项目如何申请理赔
重症疾病理赔申请 	 得了某类疾病怎样申请理赔
重症疾病怎么申请理赔 	 得了某类疾病怎样申请理赔
重症疾病如何理赔 	 得了某类疾病怎样申请理赔
重症疾病申请理赔需要准备什么 	 得了某类疾病怎样申请理赔
重症疾病保后理赔流程是如何的 	 得了某类疾病怎样申请理赔
重症疾病申领应该注意什么 	 得了某类疾病怎样申请理赔
重症疾病航班延误保险索赔要提供啥 	 得了某类疾病怎样申请理赔
重症疾病可以用身份证申请理赔吗 	 得了某类疾病怎样申请理赔
重症疾病保险单丢了影响赔付吗 	 得了某类疾病怎样申请理赔
重症疾病索赔要提供啥 	 得了某类疾病怎样申请理赔
重症疾病赔偿处理需要什么资料 	 得了某类疾病怎样申请理赔
重症疾病机票丢了还能申请理赔吗 	 得了某类疾病怎样申请理赔
重症疾病申请理赔需要的材料 	 得了某类疾病怎样申请理赔
重症疾病航班延误保险我要赔偿需要提供什么材料啊 	 得了某类疾病怎样申请理赔
重症疾病我要赔偿需要提供什么材料啊 	 得了某类疾病怎样申请理赔
重症疾病索赔要提供什么材料 	 得了某类疾病怎样申请理赔
重症疾病赔偿要什么材料 	 得了某类疾病怎样申请理赔
重症疾病赔偿要哪些材料 	 得了某类疾病怎样申请理赔
重症疾病保险金申请 	 得了某类疾病怎样申请理赔
重症疾病赔偿怎么处理 	 得了某类疾病怎样申请理赔
重症疾病保险金怎么申请 	 得了某类疾病怎样申请理赔
重症疾病怎么赔偿 	 得了某类疾病怎样申请理赔
重症疾病航班延误保险索赔的流程 	 得了某类疾病怎样申请理赔
重症疾病航班延误保险索赔申请指南 	 得了某类疾病怎样申请理赔
重症疾病航班延误保险索赔申请的注意事项 	 得了某类疾病怎样申请理赔
重症疾病航班延误保险索赔一定要提交什么材料呢 	 得了某类疾病怎样申请理赔
重症疾病航班延误险理赔需要提供什么 	 得了某类疾病怎样申请理赔
重症疾病申请索赔需要提交什么 	 得了某类疾病怎样申请理赔
重症疾病航班延误理赔需要提供身份证号码和银行卡号吗 	 得了某类疾病怎样申请理赔
重症疾病不确定航班延误保险索赔要提供什么 	 得了某类疾病怎样申请理赔
重症疾病可以告诉我航班延误保险索赔需要提供什么吗 	 得了某类疾病怎样申请理赔
重症疾病介绍一下航班延误保险索赔需要提供什么 	 得了某类疾病怎样申请理赔
重症疾病飞机延误了，我需要准备什么材料索赔 	 得了某类疾病怎样申请理赔
重症疾病如何理赔？ 	 得了某类疾病怎样申请理赔
重症疾病怎么样去理赔呢 	 得了某类疾病怎样申请理赔
重症疾病理赔有什么方法 	 得了某类疾病怎样申请理赔
重症疾病我想理赔 	 得了某类疾病怎样申请理赔
重症疾病我不知道怎么理赔 	 得了某类疾病怎样申请理赔
重症疾病理赔的流程是什么呢 	 得了某类疾病怎样申请理赔
重症疾病理赔有什么流程呢 	 得了某类疾病怎样申请理赔
重症疾病我想申请理赔 	 得了某类疾病怎样申请理赔
重症疾病我不知道怎么理赔？ 	 得了某类疾病怎样申请理赔
重症疾病能告诉我怎么理赔吗？ 	 得了某类疾病怎样申请理赔
重症疾病理赔该怎么走流程 	 得了某类疾病怎样申请理赔
重症疾病怎样申请理赔？ 	 得了某类疾病怎样申请理赔
重症疾病如何申请理赔？ 	 得了某类疾病怎样申请理赔
重症疾病申请理赔需要怎么做？ 	 得了某类疾病怎样申请理赔
重症疾病我要申请理赔，不知道流程？ 	 得了某类疾病怎样申请理赔
重症疾病可以告诉我怎样申请理赔吗？ 	 得了某类疾病怎样申请理赔
重症疾病请问一下申请理赔需要什么？ 	 得了某类疾病怎样申请理赔
重症疾病理赔材料有哪些？ 	 得了某类疾病怎样申请理赔
重症疾病保险理赔需要哪些材料？ 	 得了某类疾病怎样申请理赔
重症疾病保险理赔需要什么材料? 	 得了某类疾病怎样申请理赔
重症疾病保险的理赔材料都有哪些呢？ 	 得了某类疾病怎样申请理赔
重症疾病什么是保险的理赔材料？ 	 得了某类疾病怎样申请理赔
重症疾病哪些是保险的理赔材料呢？ 	 得了某类疾病怎样申请理赔
重症疾病都有哪些理赔材料呢？ 	 得了某类疾病怎样申请理赔
重症疾病我不知道有什么理赔材料 	 得了某类疾病怎样申请理赔
重症疾病申请理赔，需要提供什么材料呢？ 	 得了某类疾病怎样申请理赔
重症疾病可以告诉我理赔都需要什么材料吗？ 	 得了某类疾病怎样申请理赔
重症疾病我想咨询一下申请理赔需要提前准备什么？ 	 得了某类疾病怎样申请理赔
重症疾病请问一下申请理赔需要什么材料？ 	 得了某类疾病怎样申请理赔
重症疾病我想申请理赔，都有哪些材料需要准备？ 	 得了某类疾病怎样申请理赔
重症疾病我不清楚需要准备什么理赔材料？ 	 得了某类疾病怎样申请理赔
重症疾病索赔需要登机牌吗？ 	 得了某类疾病怎样申请理赔
重症疾病怎么申请索赔 	 得了某类疾病怎样申请理赔
重症疾病我怎么索赔 	 得了某类疾病怎样申请理赔
重症疾病申请理赔需要被保险人的航班订座记录吗 	 得了某类疾病怎样申请理赔
重症疾病申请理赔需要被保险人的保险购买记录吗 	 得了某类疾病怎样申请理赔
重症疾病申请理赔需要被保险人的银行账户信息吗 	 得了某类疾病怎样申请理赔
重症疾病申请理赔需要保险凭证正本吗 	 得了某类疾病怎样申请理赔
重症疾病申请理赔需要保险事故证明文件正本吗 	 得了某类疾病怎样申请理赔
重症疾病申请理赔需要航班凭证的原件吗 	 得了某类疾病怎样申请理赔
重症疾病申请理赔需要授权委托书原件受托人的身份证明等吗 	 得了某类疾病怎样申请理赔
重症疾病申请理赔需要有效保险凭证吗 	 得了某类疾病怎样申请理赔
重症疾病申请理赔需要索赔申请书吗 	 得了某类疾病怎样申请理赔
重症疾病申请理赔需要被保险人的身份证明吗 	 得了某类疾病怎样申请理赔
重症疾病申请理赔需要被保险人的登机证明吗 	 得了某类疾病怎样申请理赔
重症疾病申请理赔需要延误证明吗 	 得了某类疾病怎样申请理赔
重症疾病申请理赔需要航班取消正式书面证明文件吗 	 得了某类疾病怎样申请理赔
重症疾病申请理赔需要延误时间正式书面证明文件吗 	 得了某类疾病怎样申请理赔
重症疾病申请理赔需要证明保险事故原因损失程度的文件资料吗 	 得了某类疾病怎样申请理赔
重症疾病申请理赔需要授权委托书原件委托人和受托人的身份证明吗 	 得了某类疾病怎样申请理赔
重症疾病申请理赔需要航空公司证明吗 	 得了某类疾病怎样申请理赔
重症疾病申请理赔需要被保险人本人的银行账户信息吗 	 得了某类疾病怎样申请理赔
重症疾病没有航空公司的延误证明能否申请保险金 	 得了某类疾病怎样申请理赔
重症疾病保险人怎样领取赔偿金 	 得了某类疾病怎样申请理赔
重症疾病理赔流程 	 得了某类疾病怎样申请理赔
重症疾病发生事故，保险怎么赔 	 得了某类疾病怎样申请理赔
重症疾病发生如何理赔 	 得了某类疾病怎样申请理赔
重症疾病如何赔 	 得了某类疾病怎样申请理赔
重症疾病申请理赔具体的操作是怎么样的 	 得了某类疾病怎样申请理赔
重症疾病满足合同的理赔范围，我要怎么去申请 	 得了某类疾病怎样申请理赔
重症疾病能告诉我申请理赔都要准备些什么东西吗？ 	 得了某类疾病怎样申请理赔
重症疾病要携带什么材料？ 	 得了某类疾病怎样申请理赔
如何申领重症疾病 	 得了某类疾病怎样申请理赔
心脏病理赔申请 	 得了某个疾病怎样申请理赔
心脏病怎么申请理赔 	 得了某个疾病怎样申请理赔
心脏病如何理赔 	 得了某个疾病怎样申请理赔
心脏病申请理赔需要准备什么 	 得了某个疾病怎样申请理赔
心脏病保后理赔流程是如何的 	 得了某个疾病怎样申请理赔
心脏病申领应该注意什么 	 得了某个疾病怎样申请理赔
航班延误保险索赔要提供啥 	 保障项目如何申请理赔
可以用身份证申请理赔吗 	 理赔需要的材料
保险单丢了影响赔付吗 	 理赔需要的材料
索赔要提供啥 	 理赔需要的材料
赔偿处理需要什么资料 	 理赔需要的材料
机票丢了还能申请理赔吗 	 理赔需要的材料
申请理赔需要的材料 	 理赔需要的材料
航班延误保险我要赔偿需要提供什么材料啊 	 理赔需要的材料
我要赔偿需要提供什么材料啊 	 理赔需要的材料
索赔要提供什么材料 	 理赔需要的材料
赔偿要什么材料 	 理赔需要的材料
赔偿要哪些材料 	 理赔需要的材料
保险金申请 	 保障项目如何申请理赔 得了某类疾病怎样申请理赔 得了某个疾病怎样申请理赔
赔偿怎么处理 	 保障项目如何申请理赔 得了某类疾病怎样申请理赔 得了某个疾病怎样申请理赔
保险金怎么申请 	 保障项目如何申请理赔 得了某类疾病怎样申请理赔 得了某个疾病怎样申请理赔
心脏病怎么赔偿 	 得了某个疾病怎样申请理赔
航班延误保险索赔的流程 	 保障项目如何申请理赔
航班延误保险索赔申请指南 	 保障项目如何申请理赔
航班延误保险索赔申请的注意事项 	 保障项目如何申请理赔
航班延误保险索赔一定要提交什么材料呢 	 保障项目如何申请理赔 理赔需要的材料
航班延误险理赔需要提供什么 	 保障项目如何申请理赔 理赔需要的材料
申请索赔需要提交什么 	 理赔需要的材料
航班延误理赔需要提供身份证号码和银行卡号吗 	 保障项目如何申请理赔 理赔需要的材料
不确定航班延误保险索赔要提供什么 	 保障项目如何申请理赔 理赔需要的材料
可以告诉我航班延误保险索赔需要提供什么吗 	 理赔需要的材料
介绍一下航班延误保险索赔需要提供什么 	 理赔需要的材料
飞机延误了，我需要准备什么材料索赔 	 理赔需要的材料
如何理赔？ 	 保障项目如何申请理赔 得了某类疾病怎样申请理赔 得了某个疾病怎样申请理赔
怎么样去理赔呢 	 保障项目如何申请理赔 得了某类疾病怎样申请理赔 得了某个疾病怎样申请理赔
理赔有什么方法 	 保障项目如何申请理赔 得了某类疾病怎样申请理赔 得了某个疾病怎样申请理赔
我想理赔 	 保障项目如何申请理赔 得了某类疾病怎样申请理赔 得了某个疾病怎样申请理赔
我不知道怎么理赔 	 保障项目如何申请理赔 得了某类疾病怎样申请理赔 得了某个疾病怎样申请理赔
理赔的流程是什么呢 	 保障项目如何申请理赔 得了某类疾病怎样申请理赔 得了某个疾病怎样申请理赔
理赔有什么流程呢 	 保障项目如何申请理赔 得了某类疾病怎样申请理赔 得了某个疾病怎样申请理赔
我想申请理赔 	 保障项目如何申请理赔 得了某类疾病怎样申请理赔 得了某个疾病怎样申请理赔
我不知道怎么理赔？ 	 保障项目如何申请理赔 得了某类疾病怎样申请理赔 得了某个疾病怎样申请理赔
能告诉我怎么理赔吗？ 	 保障项目如何申请理赔 得了某类疾病怎样申请理赔 得了某个疾病怎样申请理赔
理赔该怎么走流程 	 保障项目如何申请理赔 得了某类疾病怎样申请理赔 得了某个疾病怎样申请理赔
怎样申请理赔？ 	 保障项目如何申请理赔 得了某类疾病怎样申请理赔 得了某个疾病怎样申请理赔
如何申请理赔？ 	 保障项目如何申请理赔 得了某类疾病怎样申请理赔 得了某个疾病怎样申请理赔
申请理赔需要怎么做？ 	 保障项目如何申请理赔 得了某类疾病怎样申请理赔 得了某个疾病怎样申请理赔
我要申请理赔，不知道流程？ 	 保障项目如何申请理赔 得了某类疾病怎样申请理赔 得了某个疾病怎样申请理赔
可以告诉我怎样申请理赔吗？ 	 保障项目如何申请理赔 得了某类疾病怎样申请理赔 得了某个疾病怎样申请理赔
请问一下申请理赔需要什么？ 	 保障项目如何申请理赔 得了某类疾病怎样申请理赔 得了某个疾病怎样申请理赔
理赔材料有哪些？ 	 理赔需要的材料
保险理赔需要哪些材料？ 	 理赔需要的材料
保险理赔需要什么材料? 	 理赔需要的材料
保险的理赔材料都有哪些呢？ 	 理赔需要的材料
什么是保险的理赔材料？ 	 理赔需要的材料
哪些是保险的理赔材料呢？ 	 理赔需要的材料
都有哪些理赔材料呢？ 	 理赔需要的材料
我不知道有什么理赔材料 	 理赔需要的材料
申请理赔，需要提供什么材料呢？ 	 理赔需要的材料
可以告诉我理赔都需要什么材料吗？ 	 理赔需要的材料
我想咨询一下申请理赔需要提前准备什么？ 	 理赔需要的材料
请问一下申请理赔需要什么材料？ 	 理赔需要的材料
我想申请理赔，都有哪些材料需要准备？ 	 理赔需要的材料
我不清楚需要准备什么理赔材料？ 	 理赔需要的材料
索赔需要登机牌吗？ 	 理赔需要的材料
怎么申请索赔 	 保障项目如何申请理赔 得了某类疾病怎样申请理赔 得了某个疾病怎样申请理赔
我怎么索赔 	 保障项目如何申请理赔 得了某类疾病怎样申请理赔 得了某个疾病怎样申请理赔
申请理赔需要被保险人的航班订座记录吗 	 理赔需要的材料
申请理赔需要被保险人的保险购买记录吗 	 理赔需要的材料
申请理赔需要被保险人的银行账户信息吗 	 理赔需要的材料
申请理赔需要保险凭证正本吗 	 理赔需要的材料
申请理赔需要保险事故证明文件正本吗 	 理赔需要的材料
申请理赔需要航班凭证的原件吗 	 理赔需要的材料
申请理赔需要授权委托书原件受托人的身份证明等吗 	 理赔需要的材料
申请理赔需要有效保险凭证吗 	 理赔需要的材料
申请理赔需要索赔申请书吗 	 理赔需要的材料
申请理赔需要被保险人的身份证明吗 	 理赔需要的材料
申请理赔需要被保险人的登机证明吗 	 理赔需要的材料
申请理赔需要延误证明吗 	 理赔需要的材料
申请理赔需要航班取消正式书面证明文件吗 	 理赔需要的材料
申请理赔需要延误时间正式书面证明文件吗 	 理赔需要的材料
申请理赔需要证明保险事故原因损失程度的文件资料吗 	 理赔需要的材料
申请理赔需要授权委托书原件委托人和受托人的身份证明吗 	 理赔需要的材料
申请理赔需要航空公司证明吗 	 理赔需要的材料
申请理赔需要被保险人本人的银行账户信息吗 	 理赔需要的材料
没有航空公司的延误证明能否申请保险金 	 理赔需要的材料
保险人怎样领取赔偿金 	 理赔需要的材料
理赔流程 	 保障项目如何申请理赔 得了某类疾病怎样申请理赔 得了某个疾病怎样申请理赔
发生事故，保险怎么赔 	 保障项目如何申请理赔 得了某类疾病怎样申请理赔 得了某个疾病怎样申请理赔
发生如何理赔 	 保障项目如何申请理赔 得了某类疾病怎样申请理赔 得了某个疾病怎样申请理赔
如何赔 	 保障项目如何申请理赔 得了某类疾病怎样申请理赔 得了某个疾病怎样申请理赔
申请理赔具体的操作是怎么样的 	 保障项目如何申请理赔 得了某类疾病怎样申请理赔 得了某个疾病怎样申请理赔
满足合同的理赔范围，我要怎么去申请 	 保障项目如何申请理赔 得了某类疾病怎样申请理赔 得了某个疾病怎样申请理赔
能告诉我申请理赔都要准备些什么东西吗？ 	 保障项目如何申请理赔 得了某类疾病怎样申请理赔 得了某个疾病怎样申请理赔
要携带什么材料？ 	 理赔需要的材料
如何申领 	 理赔需要的材料
犹豫期 	 询问犹豫期
犹豫期是什么 	 询问犹豫期
犹豫期多久 	 询问犹豫期
犹豫期有什么用？ 	 询问犹豫期
犹豫期对我有什么帮助吗？ 	 询问犹豫期
犹豫期有什么意义？ 	 询问犹豫期
有没有犹豫期呢 	 询问犹豫期
什么是犹豫期 	 询问犹豫期
犹豫期期间可以做什么 	 询问犹豫期
犹豫期有什么好处 	 询问犹豫期
如何利用犹豫期 	 询问犹豫期
的犹豫期是多少天？ 	 询问犹豫期
解释一下的犹豫期 	 询问犹豫期
在犹豫期间我有什么权利 	 询问犹豫期
在犹豫期内我可以放弃投保吗 	 询问犹豫期
在犹豫期内我可以做什么 	 询问犹豫期
的犹豫期内我不想投保了 	 询问犹豫期
还在犹豫期阶段，要解除合同的话应该怎么做 	 询问犹豫期
在犹豫期阶段，放弃投保要准备什么 	 询问犹豫期
犹豫期内解除合同的流程是怎样的 	 询问犹豫期
犹豫期内出事故赔吗 	 询问犹豫期
犹豫期间承担保险责任吗 	 询问犹豫期
的犹豫期 	 询问犹豫期
在犹豫期间我有什么权利 	 询问犹豫期
在犹豫期内我可以放弃投保吗 	 询问犹豫期
在犹豫期内我可以做什么 	 询问犹豫期
的犹豫期内我不想投保了 	 询问犹豫期
还在犹豫期阶段，要解除合同的话应该怎么做 	 询问犹豫期
在犹豫期阶段，放弃投保要准备什么 	 询问犹豫期
犹豫期内解除合同的流程是怎样的 	 询问犹豫期
犹豫期内出事故赔吗 	 询问犹豫期
犹豫期间承担保险责任吗 	 询问犹豫期
保险责任 	 询问保险责任
什么是保险责任 	 询问保险责任
什么情况赔偿 	 询问保险责任
保什么 	 询问保险责任
赔多少钱 	 询问保险责任
有什么情况是能申请理赔的 	 询问保险责任
保障范围 	 询问保险责任
能保什么 	 询问保险责任
都保哪些内容 	 询问保险责任
都保啥 	 询问保险责任
保险内容包括什么 	 询问保险责任
这个合同保障哪些？ 	 询问保险责任
重疾险保障哪些利益？ 	 询问保险责任
重大疾病都保吗 	 询问保险责任
介绍一下保险责任 	 询问保险责任
保险责任的意义 	 询问保险责任
保险责任对我有什么用 	 询问保险责任
什么情况下保险公司不承担责任 	 询问保险责任
合同有效期间保险公司都会承担责任吗 	 询问保险责任
请问保障项目是 	 询问保险责任
出了什么事故才会赔 	 询问保险责任
哪些情况是在承保范围的 	 询问保险责任
承担哪些保险责任 	 询问保险责任
属于保障范围内的情况有哪些 	 询问保险责任
保啥 	 询问保险责任
保险责任 	 询问保险责任
什么是保险责任 	 询问保险责任
什么情况赔偿 	 询问保险责任
保什么 	 询问保险责任
赔多少钱 	 询问保险责任
有什么情况是能申请理赔的 	 询问保险责任
保障范围 	 询问保险责任
能保什么 	 询问保险责任
都保哪些内容 	 询问保险责任
都保啥 	 询问保险责任
保险内容包括什么 	 询问保险责任
这个合同保障哪些？ 	 询问保险责任
重疾险保障哪些利益？ 	 询问保险责任
重大疾病都保吗 	 询问保险责任
介绍一下保险责任 	 询问保险责任
保险责任的意义 	 询问保险责任
保险责任对我有什么用 	 询问保险责任
什么情况下保险公司不承担责任 	 询问保险责任
合同有效期间保险公司都会承担责任吗 	 询问保险责任
请问保障项目是 	 询问保险责任
出了什么事故才会赔 	 询问保险责任
哪些情况是在承保范围的 	 询问保险责任
承担哪些保险责任 	 询问保险责任
属于保障范围内的情况有哪些 	 询问保险责任
保啥 	 询问保险责任
保险责任 	 询问保险责任
什么是保险责任 	 询问保险责任
什么情况赔偿 	 询问保险责任
保什么 	 询问保险责任
赔多少钱 	 询问保险责任
有什么情况是能申请理赔的 	 询问保险责任
保障范围 	 询问保险责任
能保什么 	 询问保险责任
都保哪些内容 	 询问保险责任
都保啥 	 询问保险责任
保险内容包括什么 	 询问保险责任
这个合同保障哪些？ 	 询问保险责任
重疾险保障哪些利益？ 	 询问保险责任
重大疾病都保吗 	 询问保险责任
介绍一下保险责任 	 询问保险责任
保险责任的意义 	 询问保险责任
保险责任对我有什么用 	 询问保险责任
什么情况下保险公司不承担责任 	 询问保险责任
合同有效期间保险公司都会承担责任吗 	 询问保险责任
请问保障项目是 	 询问保险责任
出了什么事故才会赔 	 询问保险责任
哪些情况是在承保范围的 	 询问保险责任
承担哪些保险责任 	 询问保险责任
属于保障范围内的情况有哪些 	 询问保险责任
保啥 	 询问保险责任
保险责任 	 询问保险责任
什么是保险责任 	 询问保险责任
什么情况赔偿 	 询问保险责任
保什么 	 询问保险责任
赔多少钱 	 询问保险责任
有什么情况是能申请理赔的 	 询问保险责任
保障范围 	 询问保险责任
能保什么 	 询问保险责任
都保哪些内容 	 询问保险责任
都保啥 	 询问保险责任
保险内容包括什么 	 询问保险责任
这个合同保障哪些？ 	 询问保险责任
重疾险保障哪些利益？ 	 询问保险责任
重大疾病都保吗 	 询问保险责任
介绍一下保险责任 	 询问保险责任
保险责任的意义 	 询问保险责任
保险责任对我有什么用 	 询问保险责任
什么情况下保险公司不承担责任 	 询问保险责任
合同有效期间保险公司都会承担责任吗 	 询问保险责任
请问保障项目是 	 询问保险责任
出了什么事故才会赔 	 询问保险责任
哪些情况是在承保范围的 	 询问保险责任
承担哪些保险责任 	 询问保险责任
属于保障范围内的情况有哪些 	 询问保险责任
保啥 	 询问保险责任
保险责任 	 询问保险责任
什么是保险责任 	 询问保险责任
什么情况赔偿 	 询问保险责任
保什么 	 询问保险责任
赔多少钱 	 询问保险责任
有什么情况是能申请理赔的 	 询问保险责任
保障范围 	 询问保险责任
能保什么 	 询问保险责任
都保哪些内容 	 询问保险责任
都保啥 	 询问保险责任
保险内容包括什么 	 询问保险责任
这个合同保障哪些？ 	 询问保险责任
重疾险保障哪些利益？ 	 询问保险责任
重大疾病都保吗 	 询问保险责任
介绍一下保险责任 	 询问保险责任
保险责任的意义 	 询问保险责任
保险责任对我有什么用 	 询问保险责任
什么情况下保险公司不承担责任 	 询问保险责任
合同有效期间保险公司都会承担责任吗 	 询问保险责任
请问保障项目是 	 询问保险责任
出了什么事故才会赔 	 询问保险责任
哪些情况是在承保范围的 	 询问保险责任
承担哪些保险责任 	 询问保险责任
属于保障范围内的情况有哪些 	 询问保险责任
保啥 	 询问保险责任
合同恢复 	 询问合同恢复
合同恢复是什么 	 询问合同恢复
怎么恢复合同 	 询问合同恢复
如何恢复合同 	 询问合同恢复
恢复合同流程 	 询问合同恢复
怎样才能恢复合同 	 询问合同恢复
我想恢复合同 	 询问合同恢复
恢复合同需要什么 	 询问合同恢复
可以恢复合同吗 	 询问合同恢复
恢复合同需要做什么 	 询问合同恢复
恢复合同需要提供什么 	 询问合同恢复
什么情况下可以恢复合同 	 询问合同恢复
什么时候合同效力恢复 	 询问合同恢复
保险事故通知 	 询问保险事故通知
发生事故如何通知保险公司 	 询问保险事故通知
发生事故后什么时间通知 	 询问保险事故通知
哪个时间通知保险公司 	 询问保险事故通知
发生事故后谁可以通知保险公司 	 询问保险事故通知
什么时间通知保险公司比较好 	 询问保险事故通知
没有及时通知保险公司需要承担什么后果 	 询问保险事故通知
没有及时通知保险公司会保吗 	 询问保险事故通知
保险事故通知是什么 	 询问保险事故通知
保险事故的通知 	 询问保险事故通知
出险了，要怎么通知 	 询问保险事故通知
出险了，怎么办 	 询问保险事故通知
出事故了怎么办 	 询问保险事故通知
出事后要通知谁 	 询问保险事故通知
出险后要马上通知吗 	 询问保险事故通知
出险后要第一时间通知保险公司吗 	 询问保险事故通知
出险后没有及时通知保险公司怎么办 	 询问保险事故通知
出事故后忘记通知保险公司了怎么办 	 询问保险事故通知
保单借款 	 释义项的定义
保单借款是什么 	 询问保单借款
怎么用保单向银行借款 	 询问保单借款
如何用保单向银行借款 	 询问保单借款
什么情况下可以申请保单借款 	 询问保单借款
保单借款需要什么 	 询问保单借款
保单借款收取利息吗 	 询问保单借款
借款不还会怎样 	 询问保单借款
借款不还会终止合同吗 	 询问保单借款
怎样可以申请保单借款 	 询问保单借款
最高可以借多少 	 询问保单借款
借款期限有多久 	 保单借款的还款期限
保单借款是什么 	 询问保单借款
能否保单借款 	 询问保单借款
特别约定 	 询问特别约定
有什么特别的说明 	 询问特别约定
有哪些附件条件 	 询问特别约定
有哪些额外条款 	 询问特别约定
有什么特别的地方吗 	 询问特别约定
有什么附加条件吗 	 询问特别约定
合同上有没有特别约定 	 询问特别约定
合同上有没有什么附加条件 	 询问特别约定
特别约定是什么 	 询问特别约定
特别约定有没有在合同上载明 	 询问特别约定
合同终止 	 询问合同终止
如何终止合同 	 询问合同终止
合同终止是什么 	 询问合同终止
怎么结束合同 	 询问合同终止
我想终止合同 	 询问合同终止
终止合同需要做什么 	 询问合同终止
可以终止合同吗 	 询问合同终止
怎样才能终止合同呢 	 询问合同终止
什么情况会 	 询问合同终止
终止合同合同终止 	 询问合同终止
有特别约定吗 	 询问合同终止
有没有什么附加条件 	 询问合同终止
怎么知道有没有特别约定 	 询问合同终止
的附加条件是什么 	 询问合同终止
合同生效 	 询问合同生效
保险什么时候开始生效 	 询问合同生效
哪天开始生效 	 询问合同生效
什么时候生效 	 询问合同生效
什么时候承担保险责任 	 询问合同生效
生效后有没有什么凭证 	 询问合同生效
合同生效日怎么计算的 	 询问合同生效
合同什么时候生效 	 询问合同生效
没有缴清保险费会生效吗 	 询问合同生效
合同生效 	 询问合同生效
签完合同什么时候保单开始生效 	 询问合同生效
出险通知的最佳时间 	 询问合同生效
出事故最好什么时候通知保险公司 	 询问合同生效
出险没有及时通知会影响理赔吗 	 询问合同生效
出事没有在规定时间内通知保险公司，会怎样 	 询问合同生效
对于保险事故通知有时间要求吗 	 询问合同生效
宣告死亡 	 询问宣告死亡
失踪了怎么办 	 询问失踪处理
失踪了怎么处理 	 询问失踪处理
失踪了找谁 	 询问失踪处理
失踪处理后合同怎么办 	 询问失踪处理
失踪后又出现合同怎么办 	 询问失踪处理
失踪后又出现，保险金要退吗 	 询问失踪处理
被宣告死亡后又确认没有死亡的要怎么办 	 询问失踪处理
失踪后会终止合同吗 	 询问失踪处理 询问合同解除
死亡后会终止合同吗 	 询问宣告死亡 询问合同解除
失踪处理是什么 	 询问失踪处理
死亡处理 	 询问宣告死亡
死亡了怎么办 	 询问宣告死亡
死亡了怎么处理 	 询问宣告死亡
死亡了找谁 	 询问宣告死亡
死亡处理后合同怎么办 	 询问宣告死亡
被宣告死亡后又出现合同怎么办 	 询问宣告死亡
死亡后又出现，保险金要退吗 	 询问宣告死亡
被保险人死亡了要如何处理 	 询问宣告死亡
如实告知 	 询问如实告知
如实告知合同解除 	 询问如实告知
我没有如实告知，会有什么影响？ 	 询问如实告知
没有如实告知会不会不赔偿？ 	 询问如实告知
没有如实告知有什么后果？ 	 询问如实告知
是不是一定要如实告知？ 	 询问如实告知
没有如实告知怎么办 	 询问如实告知
没有如实告知会结束合同吗 	 询问如实告知
没有如实告知还会保吗 	 询问如实告知
因重大过失没有及时通知保险公司会赔吗 	 询问如实告知
故意不如实告知的后有什么后果 	 询问如实告知
如实告知是什么 	 询问如实告知
如实告知是怎么一回事 	 询问如实告知
购买保险需要如实告知吗 	 询问如实告知
不如实告知会有什么后果 	 询问如实告知
不如实告知会影响之后的赔付吗 	 询问如实告知
不如实告知会有什么影响 	 询问如实告知
保险公司有如实告知的义务吗 	 询问如实告知
如实告知只针对投保方吗 	 询问如实告知
不理解都有什么需要如实告知 	 询问如实告知
怎么理解如实告知呢 	 询问如实告知
如实告知的义务有哪些呢 	 询问如实告知
合同解除 	 询问合同解除
合同如何解除？ 	 询问合同解除
合同解除需要提供哪些资料？ 	 询问合同解除
是否随时都可以解除合同？ 	 询问合同解除
我想解除合同 	 询问合同解除
合同可以解除吗 	 询问合同解除
如何解除合同 	 询问合同解除
解除合同需要提交什么 	 询问合同解除
解除合同需要准备什么资料 	 询问合同解除
怎样才能解除合同 	 询问合同解除
合同解除后，会退还保险金吗 	 询问合同解除
申请合同解除需要准备什么 	 询问合同解除
如何退保 	 询问合同解除
可以申请解除合同吗 	 询问合同解除
退保该怎么退 	 询问合同解除
我不想买保险了可以退费吗 	 询问合同解除
合同解除是什么 	 询问合同解除
解除保险合同 	 询问合同解除
解除合同的方法 	 询问合同解除
的退保流程 	 询问合同解除
退保要交什么资料 	 询问合同解除
任何时候都能退保吗 	 询问合同解除
解除合同要身份证吗 	 询问合同解除
退保后我能拿回我之前交的保费吗 	 询问合同解除
退保能拿回保费吗 	 询问合同解除
解除保险合同怎么操作 	 询问合同解除
保险期间 	 询问保险期间
这个保险的保险期限是多少？ 	 询问保险期间
保险期间是多少？ 	 询问保险期间
保险期限是什么？ 	 询问保险期间
保险的年限是多少？ 	 询问保险期间
保险期间有多长？ 	 询问保险期间
保险期间怎么算 	 询问保险期间
保险期间从什么时候开始 	 询问保险期间
保多久 	 询问保险期间
保险什么时候终止 	 询问保险期间
何时生效 	 询问保险期间
合同有效期是多久 	 询问保险期间
保险持续的时间 	 询问保险期间
保险期间是什么 	 询问保险期间
保险责任期限 	 询问保险期间
的保障期是？ 	 询问保险期间
的保障期是多久？ 	 询问保险期间
保费垫缴 	 询问保费垫缴
不太理解保险垫缴是什么意思？ 	 询问保费垫缴
能给我解释一下保险费的垫缴吗？ 	 询问保费垫缴
保险费如何垫缴？ 	 询问保费垫缴
保险费垫缴是可选的利益吗？ 	 询问保费垫缴
保险费垫缴有什么用？ 	 询问保费垫缴
保险费垫缴对我有什么帮助吗？ 	 询问保费垫缴
我必须得垫缴保险费吗？ 	 询问保费垫缴
没有缴付保险费怎么办 	 询问保费垫缴
没有缴付保险费会有什么后果 	 询问保费垫缴
没有交清保险费会结束合同吗 	 询问保费垫缴
没有交清保险费会保吗 	 询问保费垫缴
保费垫缴是什么 	 询问保费垫缴
什么是保费垫缴 	 询问保费垫缴
保费垫缴是什么 	 询问保费垫缴
介绍一下保费垫缴 	 询问保费垫缴
解释下保费垫缴 	 询问保费垫缴
我想了解一下保费垫缴 	 询问保费垫缴
有没有保费垫缴 	 询问保费垫缴
保费垫缴对我有啥好处 	 询问保费垫缴
没听说过保费垫缴啊 	 询问保费垫缴
保费垫缴有什么用 	 询问保费垫缴
能否保费垫缴 	 询问保费垫缴
保险金额 	 询问保险金额
保险金额是多少？ 	 询问保险金额
保险金额最高是多少？ 	 询问保险金额
最高能赔偿多少钱？ 	 询问保险金额
最高的赔偿金额是多少呢？ 	 询问保险金额
赔偿金额有多少 	 询问保险金额
保险金额可以更改吗 	 询问保险金额
保险金额什么时候会赔 	 询问保险金额
投保金额是多少 	 询问保险金额
保险金额是什么 	 询问保险金额
最高保额 	 询问保险金额
最多赔多少钱 	 询问保险金额
受益人 	 询问受益人
保险合同的受益人是谁？ 	 询问受益人
这个保险的受益人有哪些呢？ 	 询问受益人
谁是保险的受益人呢？ 	 询问受益人
保险的受益人可以是投保人吗 	 询问受益人
什么是受益人 	 询问受益人
介绍一下受益人 	 询问受益人
不太明白什么是受益人 	 询问受益人
我要是死了，钱给谁？ 	 询问受益人
我如果死了，赔偿金给谁？ 	 询问受益人
被保险人死了钱给谁？ 	 询问受益人
受益人死亡了怎么办 	 询问受益人
受益人如何变更 	 询问受益人
怎么更换受益人 	 询问受益人
受益人可以更改吗 	 询问受益人
受益人是什么 	 询问受益人
可以指定受益人 	 询问受益人
受益人是谁 	 询问受益人
体检与验尸 	 询问体检或验尸
为什么要验尸？ 	 询问体检或验尸
为什么要身体检查？ 	 询问体检或验尸
验尸有什么用？ 	 询问体检或验尸
必须得验尸吗？ 	 询问体检或验尸
什么时候要进行身体检查 	 询问体检或验尸
什么时候要验尸 	 询问体检或验尸
保险公司有权进行身体检查吗 	 询问体检或验尸
保险公司有权进行验尸吗 	 询问体检或验尸
体检与验尸是什么 	 询问体检或验尸
为什么要体检与验尸 	 询问体检或验尸
我可以拒绝体检与验尸吗 	 询问体检或验尸
体检与验尸对我有什么影响吗 	 询问体检或验尸
什么时候会体检与验尸呢 	 询问体检或验尸
不理解为什么要验尸呢 	 询问体检或验尸
体检对我有什么坏处吗 	 询问体检或验尸
可以选择不验尸吗 	 询问体检或验尸
我必须接收体检吗 	 询问体检或验尸
体检与验尸是用来干什么的 	 询问体检或验尸
未归还款项偿还 	 询问未归还款项偿还
未归还款项的偿还如何处理？ 	 询问未归还款项偿还
在办理减额缴清的时候有没有归还的款项 	 询问未归还款项偿还
在给付保险金的时候有未归还的款项 	 询问未归还款项偿还
没有归还款项，怎么办 	 询问未归还款项偿还
怎样偿还未归还款项 	 询问未归还款项偿还
在给付保险金的时候有未归还的款项怎么办 	 询问未归还款项偿还
未归还款项怎么偿还 	 询问未归还款项偿还
有未归还款项，会给付保险金吗 	 询问未归还款项偿还
未归还款项偿还是什么 	 询问未归还款项偿还
合同构成 	 询问合同构成
这个合同有哪些文件构成？ 	 询问合同构成
这个合同有什么内容？ 	 询问合同构成
合同有哪些文件？ 	 询问合同构成
合同包含什么 	 询问合同构成
合同中有什么 	 询问合同构成
合同由哪些部分组成 	 询问合同构成
保险合同构成 	 询问合同构成
合同构成是什么 	 询问合同构成
买这个保险需要什么材料 	 询问合同构成
合同一共有哪些文件 	 询问合同构成
合同有哪些文件组成 	 询问合同构成
合同里包含了什么文件 	 询问合同构成
合同里面都有哪些文件 	 询问合同构成
合同里分别有哪些文件 	 询问合同构成
合同由哪些文件构成 	 询问合同构成
合同有多少种文件组成 	 询问合同构成
合同有什么文件 	 询问合同构成
合同里面的文件分别是什么 	 询问合同构成
合同里有几个文件 	 询问合同构成
争议处理 	 询问争议处理
合同发生了争议怎么办？ 	 询问争议处理
在合同中发生了争议咋办？ 	 询问争议处理
发生了争议，与当事人协商未能解决。 	 询问争议处理
合同中发生了争议怎么解决？ 	 询问争议处理
发生争议如何处理 	 询问争议处理
争议一直没有处理怎么办 	 询问争议处理
发生争议怎样解决 	 询问争议处理
发生争议是什么 	 询问争议处理
发生争议了怎么办 	 询问争议处理
如何处理争议呢 	 询问争议处理
怎样处理争议 	 询问争议处理
处理争议有什么好的办法吗 	 询问争议处理
双方有争议了，听谁的 	 询问争议处理
发生争议了，会听我们的吗 	 询问争议处理
发生争议了，一定要听你们的吗 	 询问争议处理
怎么解决争议呢 	 询问争议处理
争议一直未解决怎么办 	 询问争议处理
意见不一了要怎么办 	 询问争议处理
投保年龄 	 询问投保年龄
投保年龄是多少？ 	 询问投保年龄
投保年龄是怎么限制的? 	 询问投保年龄
投保年龄有要求吗？ 	 询问投保年龄
投保年龄是怎么计算的？ 	 询问投保年龄
投保有年龄限制吗 	 询问投保年龄
每个年龄的人都可以投保吗 	 询问投保年龄
未成年人可以投保吗 	 询问投保年龄
1岁能买重疾吗 	 询问投保年龄
怎么计算投保年龄的 	 询问投保年龄
投保年龄会有限制吗 	 询问投保年龄
如何限制投保年龄的 	 询问投保年龄
投保年龄是什么 	 询问投保年龄
多大的人可以投保 	 询问投保年龄
我可以给小孩投保吗 	 询问投保年龄
投保年龄要求 	 询问投保年龄
有年龄要求吗 	 询问投保年龄
可以给刚出生的小孩买吗？ 	 询问投保年龄
支持什么年龄段的人投保 	 询问投保年龄
是哪个年龄段的人都可以买吗 	 询问投保年龄
对被保险人有年龄限制吗 	 询问投保年龄
能给我小孩投吗 	 询问投保年龄
允许刚出生的小孩投保吗 	 询问投保年龄
对被保险人有年龄方面的要求吗 	 询问投保年龄
是不是对任何年龄段的人开放的？ 	 询问投保年龄
支持60岁以上的人投保吗 	 询问投保年龄
能接受的最小的投保年龄是多少 	 询问投保年龄
是面向哪个年龄段的投保人购买的 	 询问投保年龄
我65岁了还能买吗？ 	 询问投保年龄
的投保年龄不能超多多少岁 	 询问投保年龄
的投保年龄不能低于多少岁 	 询问投保年龄
在投保年龄方面有限制吗 	 询问投保年龄
允许给刚出生的小孩投吗 	 询问投保年龄
适用币种 	 询问适用币种
支持哪些币种？ 	 询问适用币种
保费只能用人民币吗？ 	 询问适用币种
保费能否不用人民币？ 	 询问适用币种
可以不用人民币支付吗 	 询问适用币种
必须用人民币支付吗 	 询问适用币种
美元可以支付吗 	 询问适用币种
日元可以支付吗 	 询问适用币种
港币可以支付吗 	 询问适用币种
台币可以支付吗 	 询问适用币种
澳元可以支付吗 	 询问适用币种
人民币可以支付吗 	 询问适用币种
适用币种是什么 	 询问适用币种
保费的支付能用港币吗 	 询问适用币种
能用港币缴纳保费吗 	 询问适用币种
赔付的保险金是人民币吗 	 询问适用币种
基本保险金额 	 询问基本保险金额
基本保险金额是如何确定的？ 	 询问基本保险金额
基本保险金额如怎么约定的？ 	 询问基本保险金额
什么是基本保险金额的约定？ 	 询问基本保险金额
基本保险金额变更怎么办？ 	 询问基本保险金额
基本保险金额在哪载明？ 	 询问基本保险金额
基本保险金额可以更改吗 	 询问基本保险金额
基本保险金额可以减少吗 	 询问基本保险金额
基本保险金额是多少 	 询问基本保险金额
可以变更基本保险金额吗 	 询问基本保险金额
怎样定义基本保险金额的 	 询问基本保险金额
基本保险金额是什么 	 询问基本保险金额
能提高基本保险金额吗 	 询问基本保险金额
的基本保险金额是不变的吗 	 询问基本保险金额
合同种类 	 询问合同种类
这是什么类型的合同？ 	 询问合同种类
重疾险属于那种类型的合同？ 	 询问合同种类
这个合同保什么 	 询问合同种类
合同种类是什么 	 询问合同种类
合同有什么意义 	 询问合同种类
合同对我有什么帮助 	 询问合同种类
保险合同有几类 	 询问合同种类
保险合同分类 	 询问合同种类
保险合同是什么 	 询问合同种类
等待期 	 询问等待期
等待期有多久 	 询问等待期
等待期有多长 	 询问等待期
等待期有多长时间 	 询问等待期
等待期是什么 	 询问等待期
等待期可以申请吗 	 询问等待期
等待期内赔不赔 	 询问等待期
等待期是多长 	 询问等待期
这款产品有等待期吗 	 询问等待期
减额缴清 	 询问减额缴清
减额缴清是什么意思 	 询问减额缴清
减额缴清定义 	 询问减额缴清
减额缴清年龄要求 	 询问减额缴清
减额缴清年龄限制 	 询问减额缴清
减额缴清是什么 	 询问减额缴清
怎么办理减额缴清 	 询问减额缴清
能否减额缴清 	 询问减额缴清
能否减额交清 	 询问减额缴清
缴费方式 	 询问缴费方式
缴费方式有哪些 	 询问缴费方式
怎么缴费 	 询问缴费方式
怎么缴费 	 询问缴费方式
交费方式有哪些 	 询问缴费方式
缴费方式是什么 	 询问缴费方式
缴费年期 	 询问缴费年期
缴费年期是什么 	 询问缴费年期
缴费年期数？ 	 询问缴费年期
缴费期？ 	 询问缴费年期
重症疾病包括？ 	 疾病种类包含哪些疾病
重症疾病包括哪些 	 疾病种类包含哪些疾病
重症疾病包括哪些疾病 	 疾病种类包含哪些疾病
哪些病算重症疾病 	 疾病种类包含哪些疾病
哪些疾病算重症疾病 	 疾病种类包含哪些疾病
哪些病是重症疾病 	 疾病种类包含哪些疾病
哪些疾病是重症疾病 	 疾病种类包含哪些疾病
重症疾病有哪些 	 疾病种类包含哪些疾病
重症疾病的种类 	 疾病种类包含哪些疾病
重症疾病种类 	 疾病种类包含哪些疾病
重症疾病内容 	 疾病种类包含哪些疾病
保哪些重症疾病 	 疾病种类包含哪些疾病
哪些疾病算重症疾病 	 疾病种类包含哪些疾病
心脏病包括？ 	 疾病包含哪些疾病
心脏病包括哪些 	 疾病包含哪些疾病
心脏病包括哪些疾病 	 疾病包含哪些疾病
哪些病算心脏病 	 疾病包含哪些疾病
哪些疾病算心脏病 	 疾病包含哪些疾病
哪些病是心脏病 	 疾病包含哪些疾病
哪些疾病是心脏病 	 疾病包含哪些疾病
有哪些心脏病 	 疾病包含哪些疾病
心脏病的种类 	 疾病包含哪些疾病
心脏病种类 	 疾病包含哪些疾病
心脏病内容 	 疾病包含哪些疾病
哪些疾病算心脏病 	 疾病包含哪些疾病
保哪些疾病 	 产品保哪些疾病
这个保险保哪些疾病 	 产品保哪些疾病
哪些疾病可以赔 	 产品保哪些疾病
哪些疾病可以保 	 产品保哪些疾病
这个保险哪些疾病可以赔 	 产品保哪些疾病
这个保险哪些疾病可以保 	 产品保哪些疾病
这款保险保哪些疾病 	 产品保哪些疾病
哪些疾病可以赔付呢 	 产品保哪些疾病
哪些疾病可以保呢 	 产品保哪些疾病
保哪些疾病呢 	 产品保哪些疾病
保什么疾病 	 产品保哪些疾病
你们有哪些产品 	 询问公司有哪些产品
你们家有哪些产品 	 询问公司有哪些产品
介绍下你们家的产品 	 询问公司有哪些产品
你们公司卖什么 	 询问公司有哪些产品
你的公司卖什么产品 	 询问公司有哪些产品
你们有什么产品 	 询问公司有哪些产品
你们家的有什么产品 	 询问公司有哪些产品
你们家的有什么保险产品 	 询问公司有哪些产品
你们的有什么保险产品 	 询问公司有哪些产品
你们哪些保险产品 	 询问公司有哪些产品
你们公司有什么产品 	 询问公司有哪些产品
宽限期时间 	 询问宽限期时间
宽限期 	 询问宽限期时间
宽限期有多久 	 询问宽限期时间
宽限期有多长 	 询问宽限期时间
宽限期有多长时间 	 询问宽限期时间
宽限期是什么 	 询问宽限期时间
有宽限期吗 	 询问宽限期时间
宽限期定义 	 询问宽限期定义
到期没交保费会怎么样 	 询问宽限期定义
到期没钱交保费能延迟交吗 	 询问宽限期定义
保费没交有什么影响 	 询问宽限期定义
不交保费合同是不是就作废了 	 询问宽限期定义
保费不按时交会怎样 	 询问宽限期定义
优势 	 询问产品优势
为什么要买 	 询问产品优势
有什么优势 	 询问产品优势
有什么优点 	 询问产品优势
的特色？ 	 询问产品优势
的亮点？ 	 询问产品优势
的卖点是什么 	 询问产品优势
给我一个买的理由 	 询问产品优势
有什么价值 	 询问产品优势
心脏病属于重症疾病 	 某疾病是否属于某疾病种类
心脏病算重症疾病 	 某疾病是否属于某疾病种类
重症疾病包括心脏病吗 	 某疾病是否属于某疾病种类
心脏病是归类到重症疾病的吗 	 某疾病是否属于某疾病种类
心脏病是重症疾病吧 	 某疾病是否属于某疾病种类
免赔额定义 	 询问免赔额定义
什么是免赔额 	 询问免赔额定义
免赔额是什么 	 询问免赔额定义
介绍一下免赔额 	 询问免赔额定义
解释下免赔额 	 询问免赔额定义
我想了解一下免赔额 	 询问免赔额定义
理赔时有免赔额吗 	 询问免赔额定义
没听说过免赔额啊 	 询问免赔额定义
有免赔额吗 	 询问免赔额定义
为啥那么有免赔额啊 	 询问免赔额定义
好高的免赔额啊 	 询问免赔额定义
每个保险都有没免赔额吗 	 询问免赔额定义
是不是都有免赔额 	 询问免赔额定义
免赔额是固定的吗 	 询问免赔额定义
免赔额是怎么算的 	 询问免赔额定义
免赔额是累积的吗 	 询问免赔额定义
如何计算免赔额的 	 询问免赔额定义
免赔额是可以累积多久的 	 询问免赔额定义
免赔额每年都重新算吗 	 询问免赔额定义
怎么理解免赔额 	 询问免赔额定义
免赔额就是不赔付的金额吗 	 询问免赔额定义
免赔额的释义 	 询问免赔额定义
免赔额多少 	 询问免赔额数值
免赔额价值 	 询问免赔额数值
免赔额价格 	 询问免赔额数值
重大疾病保险免赔额多少 	 询问险种免赔额数值
重大疾病保险免赔额价值 	 询问险种免赔额数值
重大疾病保险免赔额价格 	 询问险种免赔额数值
保险费缴纳 	 询问保险费缴纳
保险费可以一次缴清吗 	 询问保险费缴纳
可以分期交付保险费吗 	 询问保险费缴纳
没有那么多钱，可以每个月交一次吗 	 询问保险费缴纳
缴纳保险费有什么需要注意的吗 	 询问保险费缴纳
都可以怎样缴保险费呢 	 询问保险费缴纳
可以晚几天缴纳保险费吗 	 询问保险费缴纳
不按时缴纳保险费有什么后果 	 询问保险费缴纳
不及时缴纳保险费对我有什么影响吗 	 询问保险费缴纳
可以过段时间再缴保险费吗 	 询问保险费缴纳
保险费可以延迟段时间缴付的吧 	 询问保险费缴纳
保险费缴纳是直接从卡里扣除吗 	 询问保险费缴纳
年缴保险费 	 询问保险费缴纳
减额缴清 	 询问诉讼时效
减额缴清是什么意思 	 询问诉讼时效
减额缴清定义 	 询问诉讼时效
减额缴清年龄要求 	 询问诉讼时效
减额缴清年龄限制 	 询问诉讼时效
减额缴清是什么 	 询问诉讼时效
怎么办理减额缴清 	 询问诉讼时效
诉讼时效 	 询问变更通讯方式
什么是诉讼时效 	 询问变更通讯方式
诉讼时效是什么 	 询问变更通讯方式
介绍一下诉讼时效 	 询问变更通讯方式
解释下诉讼时效 	 询问变更通讯方式
我想了解一下诉讼时效 	 询问变更通讯方式
有没有诉讼时效 	 询问变更通讯方式
诉讼时效有多久 	 询问变更通讯方式
诉讼时效过后可以理赔吗 	 询问变更通讯方式
没听说过诉讼时效啊 	 询问变更通讯方式
诉讼时效有什么用 	 询问变更通讯方式
诉讼时效期间可以干什么 	 询问变更通讯方式
诉讼时效是几年 	 询问变更通讯方式
联系方式变更 	 询问变更通讯方式
通讯方式的变更 	 询问变更通讯方式
如何变更联系方式 	 询问变更通讯方式
怎么变更凉席方式 	 询问变更通讯方式
要本人去更改联系方式吗 	 询问变更通讯方式
可以托人更改联系方式吗 	 询问变更通讯方式
更改联系方式需要什么文件吗 	 询问变更通讯方式
变更通讯方式需要什么资料吗 	 询问变更通讯方式
变更联系方式需要提供什么吗 	 询问变更通讯方式
可以随时变更通讯方式吗 	 询问变更通讯方式
更改联系方式的流程 	 询问变更通讯方式
我的通讯方式变了怎么办？ 	 询问变更通讯方式
的号码不用了，怎么改过来 	 询问变更通讯方式
我搬家了，的地址怎么改过来 	 询问变更通讯方式
我的电话号码换了，的要怎么更改 	 询问变更通讯方式
怎么更新住址 	 询问变更通讯方式
怎么更新电话号码 	 询问变更通讯方式
保险金给付 	 询问保险金给付
什么时候给付保险金 	 询问保险金给付
保险金怎么给付 	 询问保险金给付
申请理赔后就会给付保险金吗 	 询问保险金给付
我申请好久了，为什么还没有给付我保险金呢 	 询问保险金给付
保险金给付的条件 	 询问保险金给付
怎样才会给付保险金 	 询问保险金给付
一定会给付保险金吗 	 询问保险金给付
多少天后会给付保险金 	 询问保险金给付
心脏病投保 	 患某疾病是否可以投保
心脏病可否投保 	 患某疾病是否可以投保
心脏病能否投保 	 患某疾病是否可以投保
心脏病可以投保吗 	 患某疾病是否可以投保
心脏病可以投保 	 患某疾病是否可以投保
我有心脏病可以买重疾险吗 	 患某疾病是否可以投保
信息误告 	 询问信息误告
对年龄有什么要求 	 询问信息误告
对性别有什么要求 	 询问信息误告
需要告诉年龄吗 	 询问信息误告
需要告诉性别吗 	 询问信息误告
隐瞒年龄有什么后果 	 询问信息误告
隐瞒性别有什么后果 	 询问信息误告
实缴保险费与应缴保险费不等，合同还成立吗 	 询问信息误告
申报的被保险人年龄不真实，发生事故还会赔吗 	 询问信息误告
合同上的被保险人信息错了，怎么办 	 询问信息误告
被保险人的年龄搞错了，有影响吗 	 询问信息误告
被保险人的信息有错，出现后会影响理赔申请吗 	 询问信息误告
被保险人的信息有误 	 询问信息误告
被保险人的年龄写小了，有影响嘛 	 询问信息误告
疾病种类 	 询问疾病种类包含哪些
疾病种类有哪些 	 询问疾病种类包含哪些
疾病种类是什么 	 询问疾病种类包含哪些
疾病种类有什么 	 询问疾病种类包含哪些
有哪些疾病种类 	 询问疾病种类包含哪些
包括哪些疾病种类 	 询问疾病种类包含哪些
合作医院 	 询问合作医院
绿通的合作医院有哪些 	 询问合作医院
合作的绿通医院 	 询问合作医院
有哪些合作医院 	 询问合作医院
绿医有合作医院吗 	 询问合作医院
绿通合作医院 	 询问合作医院
重疾绿医合作医院 	 询问合作医院
绿医通道合作医院 	 询问合作医院
绿通的合作医院有哪些 	 询问合作医院
我们认可的医院？ 	 询问合作医院
认可的医院都有哪些呢 	 询问合作医院
能去哪些医院 	 询问合作医院
哪些医院是跟你们有合作的 	 询问合作医院
哪家医院跟你们有合作关系 	 询问合作医院
哪些医院有绿色通道服务 	 询问合作医院
分公司的联系方式 	 询问分公司联系方式
分公司的联系方式是什么 	 询问分公司联系方式
联系方式是什么 	 询问分公司联系方式
有那些分支机构 	 询问分公司联系方式
分支机构的联系方式是什么 	 询问分公司联系方式
怎么联系分公司 	 询问分公司联系方式
如何联系分公司 	 询问分公司联系方式
我需要分公司的联系方式 	 询问分公司联系方式
告诉我分公司的联系方式 	 询问分公司联系方式
怎样联系分公司 	 询问分公司联系方式
分公司没有联系方式吗 	 询问分公司联系方式
分公司的联系方式是什么 	 询问分公司联系方式
分公司的电话是多少 	 询问分公司联系方式
怎么取得分公司的联系方式 	 询问分公司联系方式
我不知道分公司的电话 	 询问分公司联系方式
告诉我分公司的电话号码 	 询问分公司联系方式
分公司的联系方式就是总部的那个吗 	 询问分公司联系方式
复效期 	 询问复效期
复效期是什么 	 询问复效期
复效期多久 	 询问复效期
复效期有什么用？ 	 询问复效期
复效期对我有什么帮助吗？ 	 询问复效期
复效期有什么意义？ 	 询问复效期
有没有复效期呢 	 询问复效期
什么是复效期 	 询问复效期
复效期期间可以做什么 	 询问复效期
复效期有什么好处 	 询问复效期
如何利用复效期 	 询问复效期
的复效期是多少天？ 	 询问复效期
合同恢复上限？ 	 询问复效期
复效期 	 询问复效期
复效期多长 	 询问复效期
是不是有两年的复效期 	 询问复效期
脱保后能让合同恢复效力吗 	 询问复效期
合同中止后有多长的时间可以恢复 	 询问复效期
死亡保障金赔付比例 	 询问赔付比例
死亡保障金最高赔付比例 	 询问赔付比例
死亡保障金赔付比例 	 询问赔付比例
死亡保障金赔付标准 	 询问赔付比例
死亡保障金赔付能赔付多少呢 	 询问赔付比例
死亡保障金发生意外事故可以理赔多少 	 询问赔付比例
死亡保障金保险金怎么赔 	 询问赔付比例
死亡保障金赔付额度是多少 	 询问赔付比例
死亡保障金按什么标准赔 	 询问赔付比例
死亡保障金小孩赔多少 	 询问赔付比例
死亡保障金小孩未满两岁怎么赔 	 询问赔付比例
死亡保障金的保险金额是多少 	 询问赔付比例
死亡保障金刚出生不久的小孩能赔全额吗 	 询问赔付比例
死亡保障金16岁赔多少 	 询问赔付比例
死亡保障金未成年赔的是全额吗？ 	 询问赔付比例
投保规则 	 询问投保规则
投保规矩 	 询问投保规则
投保人 	 询问投保人
那些人可以投保 	 询问投保人
那些人可以参保 	 询问投保人
哪些人可以投保 	 询问投保人
那些人可以投保 	 询问投保人
什么人可以投保 	 询问投保人
对投保人有限制吗 	 询问投保人
有犯罪记录的人能做的投保人吗 	 询问投保人
任何人都能做投保人吗 	 询问投保人
对投保人有要求吗 	 询问投保人
什么样的人不能成为的投保人 	 询问投保人
未成年人可以做的投保人吗 	 询问投保人
变更缴费方式 	 询问变更缴费方式
如何变更缴费方式 	 询问变更缴费方式
缴费方式怎么变更 	 询问变更缴费方式
缴费方式怎么改变 	 询问变更缴费方式
保保单生效后，可以更改缴费方式吗？ 	 询问变更缴费方式
现金价值？ 	 询问现金价值
现金价值是什么 	 询问现金价值
保险种类？ 	 询问保险种类
属于什么险种？ 	 询问保险种类
属于什么保险类型？ 	 询问保险种类
是什么保险类型？ 	 询问保险种类
属于什么险种？ 	 询问保险种类
是哪类险种 	 询问保险种类
是什么险 	 询问保险种类
算是什么险种 	 询问保险种类
属于哪种保险类型？ 	 询问保险种类
属于什么险 	 询问保险种类
是哪类险？ 	 询问保险种类
是哪类险种 	 询问保险种类
是什么险 	 询问保险种类
算是什么险种 	 询问保险种类
属于哪种保险类型？ 	 询问保险种类
属于什么险 	 询问保险种类
是哪类险？ 	 询问保险种类
你们是有个的保险？ 	 询问包含产品
是你们的产品吗 	 询问包含产品
是你们的保险吗 	 询问包含产品
是你们公司的吗 	 询问包含产品
增值服务 	 询问某产品增值服务项目
增值服务种类 	 询问某产品增值服务项目
有哪些增值服务 	 询问某产品增值服务项目
增值服务是什么 	 询问某产品增值服务项目
服务内容是什么 	 询问某产品增值服务项目
服务内容有哪些 	 询问某产品增值服务项目
属于什么类型的增值服务 	 询问某产品增值服务项目
增值服务类型 	 询问某产品增值服务项目
绿色通道是什么 	 询问增值服务内容
绿色通道内容 	 询问增值服务内容
绿色通道具体内容 	 询问增值服务内容
绿色通道定义 	 询问增值服务内容
绿色通道增值服务内容 	 询问增值服务内容
绿色通道服务内容是什么 	 询问增值服务内容
绿色通道服务内容包括什么 	 询问增值服务内容
绿色通道服务内容包含哪些 	 询问增值服务内容
绿色通道具体提供什么服务 	 询问增值服务内容
绿色通道有什么用 	 询问增值服务内容
绿色通道在什么情况下有用 	 询问增值服务内容
绿色通道提供什么帮助 	 询问增值服务内容
介绍下绿色通道 	 询问增值服务内容
最低保额 	 某产品的最低保额
最低保多少 	 某产品的最低保额
最少保多少 	 某产品的最低保额
最低保险金额多少 	 某产品的最低保额
最低保额多少 	 某产品的最低保额
保额是多少 	 某产品的最低保额
至少有多少保额 	 某产品的最低保额
保额下限 	 某产品的最低保额
最少能拿到多少保额 	 某产品的最低保额
保额规定 	 询问保额规定
保额规则 	 询问保额规定
保额约定 	 询问保额规定
公司介绍 	 询问公司介绍
能介绍下贵公司吗 	 询问公司介绍
介绍下中信保诚 	 询问公司介绍
介绍下你们公司 	 询问公司介绍
你们公司规模怎么样 	 询问公司介绍
你们公司有多少人 	 询问公司介绍
你们公司业务范围广吗 	 询问公司介绍
你们公司在行业内的地位怎么样 	 询问公司介绍
能给我讲讲你们公司吗 	 询问公司介绍
哪个保险能保心脏病 	 询问哪个保险保疾病
哪个保险能赔心脏病 	 询问哪个保险保疾病
什么保险能赔心脏病 	 询问哪个保险保疾病
什么保险能保心脏病 	 询问哪个保险保疾病
哪个保险保心脏病 	 询问哪个保险保疾病
哪个保险赔心脏病 	 询问哪个保险保疾病
什么保险赔心脏病 	 询问哪个保险保疾病
什么保险保心脏病 	 询问哪个保险保疾病
绿色通道使用次数 	 增值服务使用次数
绿色通道能用多少次 	 增值服务使用次数
绿色通道次数限制 	 增值服务使用次数
绿色通道数量限制 	 增值服务使用次数
绿色通道能用几次 	 增值服务使用次数
绿色通道有没有使用次数限制 	 增值服务使用次数
绿色通道有没有次数限制 	 增值服务使用次数
绿色通道有没有使用次数要求 	 增值服务使用次数
绿色通道有没有次数要求 	 增值服务使用次数
绿色通道增值服务使用次数 	 增值服务使用次数
绿色通道增值服务能用多少次 	 增值服务使用次数
绿色通道增值服务次数限制 	 增值服务使用次数
绿色通道增值服务数量限制 	 增值服务使用次数
绿色通道增值服务能用几次 	 增值服务使用次数
绿色通道增值服务有没有使用次数限制 	 增值服务使用次数
绿色通道增值服务增值服务有没有次数限制 	 增值服务使用次数
绿色通道增值服务增值服务有没有使用次数要求 	 增值服务使用次数
绿色通道增值服务有没有次数要求 	 增值服务使用次数
绿色通道使用时间 	 增值服务使用时间
绿色通道开始时间 	 增值服务使用时间
绿色通道截止时间 	 增值服务使用时间
绿色通道使用时效 	 增值服务使用时间
绿色通道有效期 	 增值服务使用时间
绿色通道使用有效期 	 增值服务使用时间
绿色通道什么时候能开始用 	 增值服务使用时间
绿色通道什么时候可以用 	 增值服务使用时间
绿色通道什么时候可以开始用 	 增值服务使用时间
绿色通道什么用到什么时候 	 增值服务使用时间
绿色通道什么用多久 	 增值服务使用时间
绿色通道增值服务使用时间 	 增值服务使用时间
绿色通道增值服务开始时间 	 增值服务使用时间
绿色通道增值服务截止时间 	 增值服务使用时间
绿色通道增值服务使用时效 	 增值服务使用时间
绿色通道增值服务有效期 	 增值服务使用时间
绿色通道增值服务使用有效期 	 增值服务使用时间
绿色通道增值服务什么时候能开始用 	 增值服务使用时间
绿色通道增值服务什么时候可以用 	 增值服务使用时间
绿色通道增值服务什么时候可以开始用 	 增值服务使用时间
绿色通道增值服务什么用到什么时候 	 增值服务使用时间
绿色通道增值服务什么用多久 	 增值服务使用时间
绿色通道服务亮点 	 增值服务亮点
绿色通道亮点 	 增值服务亮点
绿色通道特色 	 增值服务亮点
绿色通道优点 	 增值服务亮点
绿色通道好处 	 增值服务亮点
绿色通道特点 	 增值服务亮点
绿色通道增值服务服务亮点 	 增值服务亮点
绿色通道增值服务亮点 	 增值服务亮点
绿色通道增值服务特色 	 增值服务亮点
绿色通道增值服务优点 	 增值服务亮点
绿色通道增值服务好处 	 增值服务亮点
绿色通道增值服务特点 	 增值服务亮点
电话验证：1507230 	 other
全民无忧的最高保额？ 	 产品保额限制
康爱保的保障期？ 	 产品保障期限
百万信天游的免责条款？ 	 询问免责条款
满期保险金？ 	 保障项目的定义
购买百万信天游需要体检吗 	 询问体检或验尸
购买百万信天游去到国外发生意外是否可以理赔 	 理赔的地域限制
百万信天游是否保疾病 	 产品的保障内容
购买百万信天游是否可以获得信享卡 	 询问增值服务内容
全民无忧可以续保吗 	 产品能否续保
全民无忧有犹豫期吗 	 询问犹豫期
全民无忧最低保额是多少 	 某产品的最低保额
购买全民无忧需要体检吗 	 询问体检或验尸
全民无忧是保证续保吗 	 产品续保
全民无忧可以申请保单回溯吗 	 申请申请保单回溯
全民无忧可以申请减额缴清吗？ 	 询问减额缴清
全民无忧可以申请保单借款吗 	 询问保单借款
全民无忧银保通出单投保规则 	 询问投保规则
全民无忧的赔付比例 	 询问赔付比例
百万两全险介绍 	 险种介绍
信天游期满返还 	 产品期满返还
信天游回溯 	 申请保单回溯
百万信天游职业要求 	 投保的职业要求
百万信天游职业 	 投保的职业要求
信天游保障到终老吗 	 产品保障期限
信天游保障到几岁 	 产品保障期限
信天游和金悦行都是百万两全吗 	 产品是否属于某一类险
信天游有伤残比例赔付吗 	 询问赔付比例
全民无忧保额是多少 	 询问保险金额
全民无忧最高赔付多少钱 	 询问保险金额
全民无忧的投保规则 	 询问投保规则
全民无忧的宽限期 	 询问宽限期时间
全民无忧什么职业能购买 	 投保的职业要求
全民无忧的职业限制 	 投保的职业要求
全民无忧的全残 	 保障项目的定义
百万信天游如何申请理赔 	 保障项目如何申请理赔 得了某类疾病怎样申请理赔 得了某个疾病怎样申请理赔
百万信天游什么职业可以购买 	 投保的职业要求
百万信天游的职业限制 	 投保的职业要求
百万信天游的全残 	 保障项目的定义
百万信天游的受益人 	 询问受益人
百万信天游的如何申请满期保险金 	 保障项目如何申请理赔
百万信天游的为归还款项及利息的偿还 	 询问未归还款项偿还
百万信天游的保险责任的开始 	 询问保险责任
康爱保什么职业能买 	 投保的职业要求
康爱保的职业限制 	 投保的职业要求
康爱保的全残 	 保障项目的定义
电话验证18948041388	other
13977958802	other
ps好。	other
尊享惠康理赔时效是？	理赔速度
A重大疾病保险合同恢复战争等待期什么是	询问等待期
你们有什么产品？	询问公司有哪些产品
高发肿瘤基因检测需要自己自费去检查吗?	other
拨打寰宇卡号码要不要收费呢 询问增值服务内容
多久才能恢复合同	询问复效期
2000	other
重大疾病保险金合同恢复等待期有什么用	询问等待期
我在广州的话，绿医有合作医院吗\n	询问合作医院
寰宇卡里面是包括什么服务内容	询问增值服务内容
重大疾病保险金合同恢复减额缴清战争等待期什么是	询问等待期
何杰金氏病保不保	某种疾病是否在承保范围内
减额交情	询问减额缴清
合作医院有哪些	询问合作医院
重大疾病保险金怎么保	保障项目的理赔方式
重疾的定义	疾病种类的定义
赔付了轻症之后，保额会减少吗	询问保额规定
良性脑肿瘤是什么	疾病的定义
合同恢复恶性肿瘤非危及生命的极早期的恶性病变恶性肿瘤含义	释义项的定义
启泰康元	产品介绍
会刊和追奖惠康有什么区别。	产品介绍
体检保额的定义	询问体检或验尸
电话医生的使用时间是	询问增值服务内容
13383212095	other
重疾险A重大疾病保险合同恢复不知道是啥	询问复效期
孕妇投保保额有什么要求的	投保人条件限制
A重大疾病保险恶性肿瘤等待期有什么用	询问等待期
新绿医通道增加了什么服务项目	询问增值服务内容
电话验证：18677341229	other
A重大疾病保险重大疾病保险金合同恢复等待期是多少	询问等待期
重大疾病保险金恶性肿瘤赔偿吗	某种疾病是否在承保范围内
未成年父母双亡可以购买尊享惠康吗	特殊人群投保规则
24	other
A重大疾病保险我要是死了钱给谁	询问受益人
重疾险A重大疾病保险重大疾病保险金战争恶性肿瘤非危及生命的极早期的恶性病变等待期是多少	询问等待期
怎么赔钱	保障项目的理赔方式
严重瑞氏综合症保不保	 某种疾病是否在承保范围内
你们保险保什么	询问保险责任
什么叫做脑中风后遗症？	疾病的定义
什么是冠状动脉搭桥术	疾病的定义
残疾又智障的人可以投保吗	某种情景是否可以投保
哦哈哟！	other
身份证明文件有哪些	other
重大疾病保险金减额缴清战争等待期定义	询问等待期
什么是全残	释义项的定义 保障项目的定义
开门红的优惠有哪些	购买某项保险产品有无优惠
脊髓灰质炎在不在保障范围内	某种疾病的保障范围
什么是双耳失聪	疾病的定义
重大疾病保险金解释一下	保障项目的定义
怀孕投保有什么限制	询问投保规则
肠道疾病并发症赔吗	某种疾病是否在承保范围内
轻症有多少种	疾病种类包含哪些疾病
人工核保	核保不通过解决办法
什么叫不典型的心肌梗塞	疾病的定义
重疾险有免赔额吗	询问险种免赔额数值
异地就医交通补贴	询问增值服务内容
重大疾病保险金合同恢复减额缴清什么是	询问减额缴清
A重大疾病保险减额缴清战争恶性肿瘤等待期是什么	询问等待期
A重大疾病保险重疾险谁可以参保	投保人条件限制
我想知道哪些人可以投保	投保人条件限制
哪些情况不赔重大疾病保险金	保障项目的责任免除详情
开胸	释义项的定义
阿尔茨海默病赔吗	某种疾病是否在承保范围内
胆道重建手术怎么赔	某种疾病是否在承保范围内
酒驾导致的死亡赔不赔	某情景下全残或身故赔偿
心脏科	释义项的定义
冠心病的赔付	某种疾病是否在承保范围内 某种疾病是否在承保范围内
经济状况有变可以交少些保费吗	询问减额缴清
投保年龄是怎么限制的	询问投保年龄
皮肤癌在不在保障范围内	某种疾病的保障范围
如果没有指定收益人是怎么进行分配的呢？	询问受益人
治疗费用&nbsp;脑中风后遗症	疾病治疗费用
重疾险谁能参保	投保人条件限制
你可以给我介绍一下都涵盖哪些重疾保障吗	询问保障责任
国外的医院理赔要准备什么资料	申请某保障项目所需资料
申请理赔后，能让业务员上门服务吗	询问增值服务内容
中信银行手机投保流程	某渠道的投保流程
脑出血	疾病的定义
如何获得重疾绿医	询问增值服务内容
身故/全残保险金怎么赔付	保障项目的赔付
15862371815	other
60周岁投保有什么要求额	询问投保年龄
发现有不明原因出血能投保吗？	询问投保规则
中信自助终端机能否直接购买我们的保险产品	投保途径
等待期瘫痪了赔不赔\n	某种疾病是否在承保范围内 某种疾病是否在承保范围内
甲状腺结节是否属于轻症	疾病种类包含哪些疾病
那保险起见呢	释义项的定义
对投保人年龄有限制吗	询问投保年龄
公司会到倒闭吗	公司经营状况
有胸痛能投保吗	某种情景是否可以投保
身故或全残给付保险金需要什么资料	业务办理提交材料
什么是急性或亚急性重症肝炎	疾病的定义
脑血栓可以投保吗	患某疾病是否可以投保
轻症豁免是什么意思？	疾病种类豁免
病理科	释义项的定义
早期运动神经元病理赔条件	某种疾病是否在承保范围内
现在二十名。	other
什么叫宽限期	询问宽限期定义
什么叫做专家手术绿通？	释义项的定义
因职业关系导致的人类免疫缺陷病毒感染赔不赔	某种疾病是否在承保范围内 某种疾病是否在承保范围内
重疾险合同恢复减额缴清恶性肿瘤等待期定义	询问缴费年期
什么叫做不典型心肌梗塞？	疾病的定义
什么是轻度面部烧伤	疾病的定义
有什么推荐吗	产品推荐
酒驾导致的全残赔吗	某情景下全残或身故赔偿
甲状腺健康告知	询问如实告知
你们的优势是啥	询问产品优势
买保险有年龄限制吗	询问投保年龄
北京也有吗	询问分公司联系方式
生命关爱金意外	保障项目的定义
有没有文本合同	申请纸质合同
心脏起搏器植入的定义	疾病的定义
受益比例怎么填？	询问受益人
尊享惠康包括哪些重大疾病	询问保险责任
13866783495	other
全残的免责条款	询问免责条款
严重脊髓灰质炎怎么赔	某种疾病是否在承保范围内 保障项目的理赔方式
中度溃疡性结肠炎	疾病的定义
官微绑定	other
什么是保单的现金价值	询问现金价值
丝虫病所致象皮病怎么赔	某种疾病是否在承保范围内 保障项目的理赔方式
血癌保不保呢	患某疾病是否可以投保 某种疾病是否在承保范围内
保险费要一次性缴清吗	询问缴费方式
年龄填错了怎么办	询问信息误告
什么是专车接送服务	询问增值服务内容
腔静脉过滤器植入术	疾病的定义
诊断证明病理报告会怎么拿	诊断报告的领取
重大疾病保险金保多久	产品保障期限
红斑	疾病的定义
皮肤癌赔吗	某种疾病是否在承保范围内
老年人投保要求	询问投保年龄
重疾体检表格	other
索赔需要登机牌吗	理赔需要的材料
理赔有地区限制吗？	理赔的地域限制
在线问诊的时间有没有限制呢	咨询时间
重大疾病绿色就医通道	询问增值服务内容
脑炎后遗症理赔条件	理赔条件
在河北都有什么合作医院	询问合作医院
能帮我测算一下保费吗？	保费核算
开门红有哪些活动？	other
治疗医院	询问合作医院
基因检测的使用时间是什么？	询问增值服务内容
你们这个产品有生命免责条款？	询问免责条款
惠康赔了生命特别关爱金是不是合同终止	询问合同终止
法定	other
如何查询所享有的服务和权利？	服务内容介绍
肾切除在保证范围内吗	某种疾病的保障范围
电话验证+18127459424	other
重疾险重大疾病保险金合同恢复什么是	询问合同恢复
多久可以理赔到账？	理赔速度
需要缴多少钱呀	保费核算
保单借款和缴额缴清可以同时申请吗	other
多大的人可以投保	询问投保年龄
200	other
保单贷款款利率是多少	询问保单借款
寰宇卡热线电话是多少	询问联系方式
18922292269	other
能算一下费用吗	保费核算
A重大疾病保险重大疾病保险金减额缴清战争含义	other
A重大疾病保险重大疾病保险金合同恢复战争恶性肿瘤非危及生命的极早期的恶性病变恶性肿瘤干什么用的	other
A重大疾病保险重大疾病保险金合同恢复减额缴清恶性肿瘤等待期解释一下	other
专家手术绿通/	询问公司介绍
重疾险战争恶性肿瘤非危及生命的极早期的恶性病变恶性肿瘤含义	other
心包膜切除术的定义	疾病的定义
心理咨询预约流程	询问增值服务内容
犹豫期内退保有损失吗	询问犹豫期
外籍人事或港澳台人事是否能投保，具体要求？	投保人条件限制
重疾险重大疾病保险金战争恶性肿瘤非危及生命的极早期的恶性病变恶性肿瘤有什么用	other
重疾险A重大疾病保险战争恶性肿瘤是多少	other
不保哪些	责任免除
减额缴清战争恶性肿瘤非危及生命的极早期的恶性病变恶性肿瘤等待期哪些算是	other
高血压保不保	 某种疾病是否在承保范围内
总结下产品的卖点	询问产品优势
4、全残的免责条款有什么？	询问免责条款 保障免除项目的责任免除详情
健康告知四肢缺损	询问如实告知
电话验证13386729995	other
申请了保单贷款之后还可以申请减额缴清嘛	询问减额缴清
A重大疾病保险合同恢复减额缴清恶性肿瘤等待期什么是	询问缴费年期
呼吸无力	疾病的定义
重疾险A重大疾病保险重大疾病保险金减额缴清恶性肿瘤什么是	other
*终末期肾病（或称慢性肾功能衰竭尿毒症期）是什么	 疾病的定义
重大疾病保险金战争恶性肿瘤非危及生命的极早期的恶性病变等待期发生事故保险怎么赔	other
专家门诊预约服务	询问增值服务内容
A重大疾病保险重大疾病保险金合同恢复减额缴清战争含义	other
战争赔不赔	某情景是否在承保范围内
指定	询问受益人
尊享惠康这个健康险具体包括什么内容	询问保险责任
重大疾病保险金恶性肿瘤等待期要赔吗	疾病是否赔某个保障项目
未成年投保有限额吗	特殊人群投保规则
重大疾病保险金减额缴清战争什么是	other
重疾险A重大疾病保险减额缴清战争恶性肿瘤非危及生命的极早期的恶性病变等待期是多少	other
身体健康是什么意思	疾病的定义
配合反洗钱的客户身份识别制度	投保的职业要求
重大疾病保险金重疾险保险期间	询问保险期间
重疾险A重大疾病保险合同恢复恶性肿瘤非危及生命的极早期的恶性病变恶性肿瘤什么是	other
脊髓灰质炎	疾病的定义
重疾险重大疾病保险金合同恢复减额缴清战争恶性肿瘤非危及生命的极早期的恶性病变不知道是啥	other
31岁	other
现在可以介绍什么产品	产品介绍
重大疾病保险金什么情况下不保	保障项目的责任免除详情
肾功能衰竭在不在保障范围内	某种疾病的保障范围
有便血能投保吗？	某种情景是否可以投保
惠康升级为尊享惠康怎么做\t\t\t\t\t\t\t\t	other
继发性肺动脉高压保不保	患某疾病是否可以投保
上海合作医院	询问合作医院
重疾险谁是保险的受益人呢	询问受益人
A重大疾病保险重大疾病保险金减额缴清战争等待期解释一下	other
重疾绿医通道具体是怎么样的	询问增值服务内容
vip银卡有什么服务	询问增值服务内容
早期心肌病的定义	疾病的定义
A重大疾病保险重大疾病保险金减额缴清恶性肿瘤含义	other
变更受益人	询问受益人 询问合同变更
国外的医院的要求	国外医院的要求
重大疾病保险金恶性肿瘤非危及生命的极早期的恶性病变出事故都会赔偿吗	other
患了轻症怎么赔付呢？	疾病种类的赔付流程
颅脑手术的定义	疾病的定义
严重类风湿性关节元	疾病的定义
可以中途退保吗？	询问合同解除
重疾体检标准是怎么样	体检标准
重大疾病保险金合同恢复战争恶性肿瘤非危及生命的极早期的恶性病变能否赔偿	other
轻症疾病有哪些	疾病种类包含哪些疾病
手机银行购买限额	投保途径
保险人有意失踪会赔吗	保障项目的责任免除详情
海外二次诊疗意见是什么服务	询问增值服务内容
重大疾病保险金合同恢复战争恶性肿瘤非危及生命的极早期的恶性病变等待期有什么用	询问等待期
北京有哪些绿医合作医院	询问合作医院
90种重疾都有哪些?	疾病种类包含哪些疾病
哪里可以购买	投保指引
重大疾病保险金合同恢复减额缴清恶性肿瘤非危及生命的极早期的恶性病变等待期有什么用	询问等待期
得哪些疾病需要告知？	询问如实告知
惠康能升级吗	other
A重大疾病保险重大疾病保险金合同恢复减额缴清等待期哪些算是	other
轻症是怎么赔付的呢	疾病种类的赔付流程
重疾险A重大疾病保险重大疾病保险金减额缴清恶性肿瘤等待期干什么用的	询问减额缴清
严重阿尔茨海默病是什么	疾病的定义
重疾险合同恢复减额缴清恶性肿瘤非危及生命的极早期的恶性病变恶性肿瘤什么是	other
A重大疾病保险合同恢复战争恶性肿瘤定义	other
A重大疾病保险合同恢复战争恶性肿瘤等待期什么是	other
A重大疾病保险合同恢复战争恶性肿瘤非危及生命的极早期的恶性病变恶性肿瘤不知道是啥	other
理赔能让业务员上门服务吗？	询问增值服务内容
重疾险合同恢复减额缴清战争恶性肿瘤非危及生命的极早期的恶性病变恶性肿瘤什么是	other
ceo是谁	other
重疾险战争有什么用	other
A重大疾病保险重大疾病保险金是啥	保障项目的定义
癌症是可以保的吧	患某疾病是否可以投保 某种疾病是否在承保范围内
重大疾病保险金合同恢复战争恶性肿瘤非危及生命的极早期的恶性病变是否赔偿	other
什么事保单回溯/	申请保单回溯
重大疾病保险金减额缴清哪些算是	other 询问减额缴清
1368686868613618623375	other
体检要求	 体检标准
重大疾病保险金减额缴清战争恶性肿瘤非危及生命的极早期的恶性病变恶性肿瘤是多少	询问减额缴清
国内神经内科第一的医院	询问合作医院
重疾险A重大疾病保险战争恶性肿瘤非危及生命的极早期的恶性病变干什么用的	other
重疾险合同恢复减额缴清恶性肿瘤非危及生命的极早期的恶性病变等待期什么意思	other
可以附加什么附加险	询问附加险
请问惠康的缴费期选择的是缴至60周岁，不能升级成《尊享惠康》，也不能附加轻症豁免，是吗？	other
A重大疾病保险重大疾病保险金合同恢复恶性肿瘤等待期有什么用	other
电话医生的特点	询问增值服务内容
重大疾病保险金减额缴清战争恶性肿瘤等待期哪些算是	other
重疾险战争恶性肿瘤非危及生命的极早期的恶性病变恶性肿瘤定义	other
有哪些高发病	高发疾病
重疾险是啥	保障项目的定义
重疾险重大疾病保险金战争恶性肿瘤非危及生命的极早期的恶性病变等待期定义	other
请介绍一下你们公司	询问公司介绍
拨打寰宇卡电话需不需收费的呢/	other
重疾险重大疾病保险金战争恶性肿瘤非危及生命的极早期的恶性病变有什么用	other
发生争议如何处理	询问争议处理
了解，谢谢	other
你帮我说一下费用。	保费核算
不是女的。	other
重大疾病保险金战争恶性肿瘤非危及生命的极早期的恶性病变恶性肿瘤赔不赔	other
特定脑损伤保不保	患某疾病是否可以投保 某种疾病是否在承保范围内
重大疾病保险金战争恶性肿瘤非危及生命的极早期的恶性病变等待期有什么用	other
复效期交费	询问复效期
18926683310+18926683310	other
我在广州的话，绿医有合作医院吗\t\t\t\t\t\t\t\t	询问合作医院
重疾险重大疾病保险金合同恢复不知道是啥	询问复效期
保险什么时候终止	产品保障期限
16，全残有保障吗	某种情景是否可以投保
有理财产品吗	询问公司有哪些产品
tjsqyh添加授权用户：o1PQT0sSab0Xe8pZBAzsYEEOiqyc	other
申请理赔需要被保险人本人的银行账户信息吗	得了某类疾病怎样申请理赔
传家体检规则	体检标准
重疾险重大疾病保险金合同恢复减额缴清战争恶性肿瘤非危及生命的极早期的恶性病变定义	other
重疾险A重大疾病保险重大疾病保险金等待期什么是	other
减额缴清恶性肿瘤非危及生命的极早期的恶性病变等待期是啥	other
重疾险A重大疾病保险恶性肿瘤等待期含义	other
重疾险保险金额可以更改吗	询问合同变更
绿色就医通道怎么用	询问增值服务内容
退出。	other
发生轻症后再发生重疾最后再癌症怎么赔	保障项目的赔付方式
身故保险金什么情况下免责	保障项目的责任免除详情
A重大疾病保险重大疾病保险金合同恢复战争什么是	other
今天	other
A重大疾病保险介绍一下受益人	询问受益人
重疾险受益人可以更改吗	询问合同变更
*严重原发性肺动脉高压是什么	疾病的定义
皮肤癌是重疾吗	某疾病是否属于某疾病种类
重疾险合同恢复减额缴清恶性肿瘤非危及生命的极早期的恶性病变恶性肿瘤什么意思	other
严重脑损伤理赔条件	理赔条件
急性心肌梗塞赔吗\n	某种疾病是否在承保范围内
电话验证+15354112886	other
重大疾病保险金适用币种	other
重大疾病保险金合同恢复战争恶性肿瘤非危及生命的极早期的恶性病变等待期什么意思	other
检测结果准确吗？	询问增值服务内容
心肌病和心肌炎也是心脏病范畴巴	疾病的定义
中途可以退保吗	询问合同解除
A重大疾病保险重大疾病保险金减额缴清恶性肿瘤非危及生命的极早期的恶性病变恶性肿瘤是啥	other
重疾险A重大疾病保险重大疾病保险金什么是	other
什么是	other
没有如实告知怎么办	询问如实告知
怎么理赔啊	保障项目的理赔方式
我想退保。	询问合同解除
一型糖尿病并发肾病	疾病的定义
A重大疾病保险重大疾病保险金合同恢复减额缴清恶性肿瘤非危及生命的极早期的恶性病变恶性肿瘤等待期是多少	other
保险金有什么要求	other
A重大疾病保险合同恢复恶性肿瘤非危及生命的极早期的恶性病变是啥	other
尊享惠康对职业有要求吗	投保的职业要求
13505607245	other
父母有病史需要说明吗	询问如实告知
尊享惠康可以返本吗?	other
四项肿瘤检测是哪些	询问增值服务内容
借款的利息怎么算	询问保单借款
合同恢复恶性肿瘤非危及生命的极早期的恶性病变恶性肿瘤等待期什么意思	other
69	other
良性脑肿瘤赔不赔	某种疾病是否在承保范围内 某种疾病是否在承保范围内
重疾绿通服务内网	询问增值服务内容
17398398810	other
尊享惠康附加险种有哪些	询问附加险
A重大疾病保险重大疾病保险金合同恢复战争恶性肿瘤非危及生命的极早期的恶性病变等待期干什么用的	other
重大疾病保险金战争恶性肿瘤非危及生命的极早期的恶性病变恶性肿瘤等待期是多少	other
性别男。	other
体检限额	体检指引
验证成功了吗～	other
健康告知曾经患有血友病	other
申请保险金资料	业务办理提交材料
A重大疾病保险重大疾病保险金减额缴清恶性肿瘤非危及生命的极早期的恶性病变恶性肿瘤有什么用	other
A重大疾病保险合同恢复恶性肿瘤非危及生命的极早期的恶性病变等待期解释一下	other
严重弥漫性系\r统性硬皮病<div>\n</div>	疾病的定义
合同恢复减额缴清战争恶性肿瘤非危及生命的极早期的恶性病变是多少	other
申请理赔要什么资料	申请某保障项目所需资料
甲状腺结节能投保吗	患某疾病是否可以投保 某种疾病是否在承保范围内
恶性肿瘤不知道是啥	疾病的定义
重疾险重大疾病保险金合同恢复减额缴清战争恶性肿瘤非危及生命的极早期的恶性病变恶性肿瘤等待期是多少	other
呼吸科排名第一的医院是什么？	询问合作医院
重疾险重大疾病保险金合同恢复减额缴清战争哪些算是	other
咋申请理赔	保障项目如何申请理赔
A重大疾病保险重大疾病保险金合同恢复减额缴清战争恶性肿瘤哪些算是	other
重大疾病保险金恶性肿瘤非危及生命的极早期的恶性病变干什么用的	other
重大疾病责任保额意义	other
什么是特别生命关爱金	保障项目的定义
合同变更	询问合同变更
什么是在线问诊	询问增值服务内容
倒闭了怎么办	公司经营状况
三十五岁。	other
重疾险重大疾病保险金合同恢复战争恶性肿瘤非危及生命的极早期的恶性病变哪些算是	other
健康告知正患有甲状腺疾病	other
nb	other
重疾险战争等待期是什么	询问等待期
健康告知曾经感染艾滋病病毒	询问如实告知
缴费规则	询问缴费方式
A重大疾病保险减额缴清战争恶性肿瘤是什么	other
高发肿瘤基因检测使用次数	询问增值服务内容
电话验证：15377023505	other
惠康和尊享惠康的区别是什么	保险产品对比
尊享惠康具备返本的功能吗？	other
特定周围动脉疾病的血管介入治疗\r<div>\n</div>	疾病的定义
帮我做一份零岁宝宝我真想惠康十万保额的计划。	保费核算
重大疾病保险金有哪些附件条件	保障项目的赔付 理赔条件
轻症豁免的费用是一年一年交的吗?	询问缴费方式
理赔需要准备什么资料？	申请某保障项目所需资料
中途可以退退保吗	询问合同解除
重疾险重大疾病保险金合同恢复恶性肿瘤非危及生命的极早期的恶性病变恶性肿瘤什么是	other
脑溢血能保吗	某种疾病是否在承保范围内
新发现有艾滋病	释义项的定义
犹豫期有多少天	询问犹豫期
恶性肿瘤保不保	 某种疾病是否在承保范围内
老年人能不能做投保人	询问投保年龄
重大疾病绿医通道	询问增值服务内容
轻症豁免费用也是一年一年交的吗	询问保险费缴纳 
产品比同行有什么优势吗	询问产品优势
基因检测的项目	询问增值服务内容
体检包括什么项目	某项体检的包含项
90种重大疾病种类	疾病种类包含哪些疾病
有什么产品推荐呢	产品推荐
全国	other
高发肿瘤基因检查	询问增值服务内容
合同恢复减额缴清恶性肿瘤哪些算是	other
重疾险A重大疾病保险重大疾病保险金合同恢复恶性肿瘤非危及生命的极早期的恶性病变等待期解释一下	other
严重冠心病是什么	疾病的定义
艾滋病保不	某种情景是否可以投保 某种疾病是否在承保范围内
保费核算	保费核算
重大疾病保险金合同恢复战争恶性肿瘤非危及生命的极早期的恶性病变是什么	other
重疾险A重大疾病保险战争恶性肿瘤是啥	other
重大疾病保险金合同恢复恶性肿瘤非危及生命的极早期的恶性病变哪些算是	other
严重肌营养不良症赔不赔	某种疾病是否在承保范围内
你是男的啊	other
选多少年合适嗯	询问缴费年期
可爱个屁	other
重大疾病保险金等待期发生有保障吗	other
患有神经炎可以投保吗	某种情景是否可以投保
有没有什么分红险推荐	产品推荐
慢性肝功能衰竭失代偿期是什么	疾病的定义
双侧卵巢或睾丸切除术的定义	疾病的定义
恶性肿瘤保马	患某疾病是否可以投保 某种疾病是否在承保范围内
生命保险金包括？	保障项目保哪些疾病
生命保险金包括哪些	保障项目保哪些疾病
生命保险金包括哪些疾病	保障项目保哪些疾病
哪些病算生命保险金	保障项目保哪些疾病
哪些疾病算生命保险金	保障项目保哪些疾病
哪些病是生命保险金	保障项目保哪些疾病
哪些疾病是生命保险金	保障项目保哪些疾病
生命保险金有哪些	保障项目保哪些疾病
生命保险金的种类	保障项目保哪些疾病
生命保险金种类	保障项目保哪些疾病
生命保险金内容	保障项目保哪些疾病
保哪些生命保险金	保障项目保哪些疾病
哪些疾病算生命保险金	保障项目保哪些疾病
私家车加盟网约车公司，车辆与驾驶员都符合条款的网约车定义。在未接单/去接客户的期间发生意外身故、全残，对于驾驶员，百万信天游是否提供保障？将如何理赔？	保障项目的理赔方式
客户投保了百万信天游，并依法成为网约车司机，在驾驶网约车期间发生意外伤害事故导致身故，如在保险责任范围内，请问公司将如何给付？	询问保险金给付
百万信天游是否存在健康及职业加费情况？职业等级5级以上能否投保？	投保的职业要求 询问保险责任
客户投保了康爱保。被保人60岁时不幸罹患了肺癌（被确诊时基本保险金额为10万），如属于赔付范围，可获赔多少？	保障项目的理赔方式
客户投保了康爱保。被保人在60岁时不幸被确诊为恶性肿瘤（非特定癌症保险金所列疾病，被确诊时基本保险金额为10万），如属于赔付范围，可获赔多少？	保障项目的理赔方式
百万信天游超过60周岁还可以投保吗？	保障项目的年龄限制 投保人条件限制
全民无忧的保额有限制吗？	产品保额限制 询问保险金额
全民无忧可以买多少保额？	询问保险金额
百万信天游保单生效后，乘坐公交车身故可以赔多少保险金？	询问合同生效 某种情景是否可以投保
百万信天游保单生效后，乘坐航空出了事故怎么赔？	询问合同生效 某情景下全残或身故赔偿
百万信天游有哪些保障？	询问保险责任
百万信天游都有那些保障？	询问保险责任
康爱保保障的疾病都有那些	询问保险责任
未成年人患了白血病怎么赔？	得了某类疾病怎样申请理赔
客户投保了百万信天游，选择租车自驾游，请问驾车期间出现意外身故/全残，是否能按“租赁车、网约车意外身故或全残保险金”理赔？	询问保险责任
60周岁以上能作为投保人吗？	保障项目的年龄限制 投保人条件限制
66周岁可以购买康爱保吗？	保障项目的年龄限制
百万信天游自驾车是否提供10倍保额	询问保险金额 询问保险责任
百万信天游满期保险金给付多少	询问保险金给付
投保百万信天游需要体检吗	询问体检或验尸
购买百万信天游理赔是否有地域限制	产品保障的地域限制
购买康爱保去到国外发生风险是否可以理赔	理赔的地域限制
百万信天游对于疾病是否有保障	询问保险责任
百万信天游里面有疾病保险金吗	产品介绍
购买百万信天游可以赠送信享卡吗	询问增值服务内容
全民无忧是否可以续保	询问保险责任 产品续保
全民无忧是否有犹豫期	询问犹豫期
全民无忧最低可以买多少保额	产品保额限制
投保全民无忧需要体检吗	询问体检或验尸
全民无忧可以保证续保吗	产品续保
全民无忧是否具备保单回溯功能	申请保单回溯
全民无忧有减额缴清的功能吗	询问减额缴清
全民无忧有保单借款的功能吗	询问保单借款
银保通出单对于全民有没有什么投保规则	询问投保规则
全民无忧理赔是的赔付比例是多少？	询问赔付比例
康爱保对于身故怎么赔付	保障项目如何申请理赔 得了某类疾病怎样申请理赔 得了某个疾病怎样申请理赔
康爱保中途退保会有损失吗	询问合同解除
投保康爱保在国外发生风险可以理赔吗	理赔的地域限制
康爱保可以保多久	产品保障期限
康爱保什么时候返本呢	other
康爱保保原位癌吗	某种疾病是否在承保范围内
投保百万信天游赠送的信享卡服务时间是多久	询问增值服务内容
网约车司机投保百万信天游有10倍保障吗	other
出租车司机投保百万信天游有10倍保障吗	other
全民无忧有多少天宽限期	询问宽限期时间
全民无忧是否有复效期	询问复效期
投保康爱保和医社保有冲突吗	商业保险与医保的关系
百万信天游和医社保有冲突吗	商业保险与医保的关系
全民无忧体检项目有哪些	询问体检或验尸
百万信天游是否可以选择月缴	询问缴费年期
康爱保是否可以选择月缴	询问缴费年期
百万信天游是否可以变更受益人	询问受益人
百万信天游怎么变更受益人	询问受益人
康爱保是否可以变更受益人	询问受益人
康爱保怎么变更受益人	询问受益人
全民无忧的宽限期	 询问宽限期时间
全民无忧什么职业能购买	 投保的职业要求
全民无忧的职业限制	 投保的职业要求
全民无忧的全残	 保障项目的定义
百万信天游如何申请理赔	 保障项目如何申请理赔 得了某类疾病怎样申请理赔 得了某个疾病怎样申请理赔
百万信天游什么职业可以购买	 投保的职业要求
百万信天游的职业限制	 投保的职业要求
百万信天游的全残	 保障项目的定义
百万信天游的受益人	 询问受益人
百万信天游如何申请期满保险金	保障项目如何申请理赔
百万信天游的未归还款项及利息偿还	询问未归还款项偿还
百万信天游的保险责任的开始	 询问保险责任
康爱保什么职业能买	 投保的职业要求
康爱保的职业限制	 投保的职业要求
康爱保的全残	 保障项目的定义
全残	释义项的定义
已缴年费期数	询问缴费年期
年缴费方式下的标准年缴保费	询问缴费方式
意外伤害事故	释义项的定义
现金价值	释义项的定义
我们认可的医院	理赔医院
保险费应缴日	释义项的定义
未归还款项	释义项的定义
利息	释义项的定义
康爱保的保险合同的种类错误	询问合同种类
康爱保的基本保险金额和保险金额	询问基本保险金额
康爱保的保险期间	产品保障期限
康爱保恶性肿瘤保险金	保障项目的定义
康爱保特定癌症保险金	保障项目的定义
康爱保如何申请理赔	保障项目如何申请理赔 得了某类疾病怎样申请理赔 得了某个疾病怎样申请理赔
康爱保保险费的垫缴	询问保费垫缴
康爱保合同效力的恢复	询问合同恢复
康爱保保险单借款的解释	释义项的定义
康爱保为归还款项的偿还解释	询问未归还款项偿还
康爱保保险责任的开始解释	询问保险责任 释义项的定义
康爱保的遗传性疾病	疾病的定义
康爱保我们认可的医院	理赔医院
康爱保保险费应缴日	other
康爱保为归还款项	询问未归还款项偿还
康爱保保单年度	other
康爱保恶性肿瘤	疾病的定义
康爱保前列腺癌	疾病的定义
全民无忧的基本保险金额	询问基本保险金额
什么是基本保险金额	释义项的定义
基本保险金额是什么	释义项的定义
其他免责条款	询问免责条款
全民无忧的其他免责条款	询问免责条款
什么是其他免责条款	询问免责条款
什么是全民无忧的其他免责条款	询问免责条款
全民无忧的其他免责条款是什么	询问免责条款
什么是保险合同的构成	询问合同构成 释义项的定义
保险合同的构成是什么	询问合同构成 释义项的定义
全民无忧的保险责任的开始	询问保险责任
什么是保险责任的开始	询问保险责任 释义项的定义
保险责任的开始是什么	询问保险责任 释义项的定义
全民无忧的投保年龄	询问投保年龄
投保年龄是什么	询问投保年龄 释义项的定义
什么是投保年龄	询问投保年龄 释义项的定义
全民无忧的年龄误告	询问信息误告
年龄误告是什么	询问信息误告 释义项的定义
什么是年龄误告	询问信息误告 释义项的定义
全民无忧变更通讯方式	询问变更通讯方式
全民无忧的变更通讯方式	询问变更通讯方式
什么是变更通讯方式	询问变更通讯方式
变更通讯方式是什么	询问变更通讯方式
特定门诊医疗费	产品费用与报销
全民无忧特定门诊医疗费	产品费用与报销
什么是特定门诊医疗费	产品费用与报销
特定门诊医疗费是什么	产品费用与报销
赔付比例及免赔额表	询问赔付比例
全民无忧赔付比例及免赔额表	询问赔付比例
什么是赔付比例及免赔额表	询问赔付比例
赔付比例及免赔额表是什么	询问免赔额定义 询问赔付比例
全民无忧保障多久？	产品保障期限
康爱保保障多久？	产品保障期限
全民无忧可以保障多久？	产品保障期限
康爱保可以保障多久？	产品保障期限
康爱保的保障期是？	产品保障期限
康爱保的保障期是多久？	产品保障期限
康爱保保障的疾病都有哪些？	询问保险责任
有哪些疾病是康爱保的保障范围？	询问保险责任
康爱保保障的疾病种类？	询问保险责任
百万信天游的保障范围	询问保险责任
百万信天游的保险责任	询问保险责任
康爱保能保多久	产品保障期限
全民无忧可以保多久？	产品保障期限
全民无忧能保障多久？	产品保障期限
康爱保需要体检吗？	询问体检或验尸
康爱保的体检标准	体检标准
全民无忧需要体检吗？	询问体检或验尸
购买百万信天游需要体检吗？	 询问体检或验尸
全民无忧的体检标准	体检标准
购买全民无忧需要体检吗？	 询问体检或验尸
全民无忧的体检标准是什么？	体检标准
全民无忧的体检标准有哪些？	体检标准
全民无忧如果需要体检，体检的项目有那些？	询问体检或验尸
全民无忧的体检项目有哪些？	询问体检或验尸
投保全民无忧如果需要体检，那需要做哪些体检项目呢？	询问体检或验尸
超过51周岁投保全民无忧需要做哪些体检项目	询问体检或验尸 保障项目的年龄限制
投保全民无忧51周岁体检需要做哪些项目？	询问体检或验尸
全民无忧银保通出单规定有哪些？	other
投保康爱保51周岁可以选择的缴费期是？	询问缴费年期
51周岁投保康爱保可以选择多少年缴？	询问缴费年期
51周岁投保康爱保可以选择交多少年？	询问缴费年期
百万信天游乘坐客运轮船身故	某情景下全残或身故赔偿
百万信天游乘坐渡轮身故	某情景下全残或身故赔偿
百万信天游乘坐列车身故	某情景下全残或身故赔偿
百万信天游乘坐地铁身故	某情景下全残或身故赔偿
百万信天游乘坐轻轨身故	某情景下全残或身故赔偿
百万信天游乘坐磁悬浮列车身故	某情景下全残或身故赔偿
百万信天游乘坐其他客运列车身故	某情景下全残或身故赔偿
百万信天游乘坐汽车身故	某情景下全残或身故赔偿
百万信天游乘坐公共汽车身故	某情景下全残或身故赔偿
百万信天游乘坐公共电车身故	某情景下全残或身故赔偿
百万信天游乘坐出租汽车身故	某情景下全残或身故赔偿
百万信天游乘坐货车身故	某情景下全残或身故赔偿
百万信天游乘坐客货两用车身故	某情景下全残或身故赔偿
百万信天游乘坐轨道交通车辆身故	某情景下全残或身故赔偿
百万信天游乘坐警车身故	某情景下全残或身故赔偿
百万信天游乘坐救护车身故	某情景下全残或身故赔偿
百万信天游乘坐消防车身故	某情景下全残或身故赔偿
百万信天游工程抢险车身故	某情景下全残或身故赔偿
百万信天游乘坐工程作业车身故	某情景下全残或身故赔偿
百万信天游乘坐公路监督检查专用车身故	某情景下全残或身故赔偿
百万信天游乘坐公路养护车身故	某情景下全残或身故赔偿
百万信天游乘坐清障车身故	某情景下全残或身故赔偿
百万信天游乘坐救援车身故	某情景下全残或身故赔偿
百万信天游乘坐洒水车身故	某情景下全残或身故赔偿
百万信天游乘坐清扫车身故	某情景下全残或身故赔偿
百万信天游乘坐拖拉机身故	某情景下全残或身故赔偿
百万信天游乘坐公司上下班班车身故	某情景下全残或身故赔偿
百万信天游乘坐单位上下班班车身故	某情景下全残或身故赔偿
百万信天游乘坐公司（单位）上下班班车身故	某情景下全残或身故赔偿
百万信天游乘坐农用车辆身故	某情景下全残或身故赔偿
康爱保得了白血病怎么赔	得了某类疾病怎样申请理赔
康爱保得了脑癌怎么赔	得了某类疾病怎样申请理赔
康爱保得了骨癌怎么赔	得了某类疾病怎样申请理赔
康爱保得了肺癌怎么赔	得了某类疾病怎样申请理赔
康爱保得了前列腺癌怎么赔	得了某类疾病怎样申请理赔
康爱保得了肝癌怎么赔	得了某类疾病怎样申请理赔
康爱保得了乳腺癌怎么赔	得了某类疾病怎样申请理赔
康爱保得了宫颈癌怎么赔	得了某类疾病怎样申请理赔
康爱保身故怎么赔	保障项目如何申请理赔 得了某类疾病怎样申请理赔 得了某个疾病怎样申请理赔
康爱保保险期间	产品保障期限
康爱保保障时间	产品保障期限
康爱保缴费期	询问缴费年期
康爱保缴费方式	询问缴费方式
保单生效后，可以办理减额缴清吗？	询问合同生效 询问减额缴清
全民无忧保障期	产品保障期限
全民无忧缴费期	询问缴费年期
全民无忧缴费方式	询问缴费方式
全民无忧的免赔额	询问免赔额定义
得了轻症是怎么进行赔付的	疾病种类的赔付流程
咳嗽可以投保吗	患某疾病是否可以投保 某种疾病是否在承保范围内
忘记交钱怎么办	询问争议处理
重大疾病保险金申请合同解除需要准备什么	询问合同解除
人死了，保费怎么办	询问宣告死亡
/,@-D	other
四肢缺损投保健康告知	询问如实告知
考虑考虑	other
都保哪些	询问保险责任
还能投保惠康吗	other
<div>.得了轻症，豁免保费了之后，还可以保单贷款吗</div><div>\n</div>	询问保单借款
等待期多少天	询问等待期
语言能力丧失的病因是什么	疾病发病原因
健康告知有帕金森氏症能通过核保吗	询问如实告知
绿色就医通道。	询问增值服务内容
隔代投保要什么证件	询问投保规则
你们卖哪些保险啊	询问公司有哪些产品
保障时间	询问保险期间
隔代投保	询问投保规则
高发疾病都有哪些	疾病种类包含哪些疾病
在职业方面有没有要求	投保的职业要求
产品的亮点	询问产品优势
手机投保流程	投保途径
健康&nbsp;测评	询问增值服务内容
理赔速度怎么快	理赔速度
有效驾驶证	释义项的定义
严重胃肠炎的定义	疾病的定义
健康告知女性有乳腺纤维瘤能通过核保吗	询问如实告知
有什么健康险推荐	产品推荐
保额表	询问保额
健康告知曾经患有高血压	询问如实告知
在哪可以购买？	投保指引
中信保城的历史	询问公司介绍
我想咨询一下申请理赔需要提前准备什么	保障项目如何申请理赔
失明	疾病的定义
严重细菌性脑脊髓膜炎赔不赔	某种疾病是否在承保范围内 某种疾病是否在承保范围内
健康告知有心脏病能通过核保吗	询问如实告知
现在几点	咨询时间
如果没有指定受益人，如何分配	询问受益人
财务告知有什么作用	询问如实告知
绑定官微的流程	某渠道的投保流程
重疾险重大疾病保险金减额缴清解释一下	询问减额缴清
健康告知曾经患有脑中风	询问如实告知
有帕金森氏症能投保吗	某种疾病是否在承保范围内 某种疾病是否在承保范围内
重疾险重大疾病保险金减额缴清含义	询问减额缴清
重疾险合同恢复减额缴清等待期什么是	询问等待期
基因检测怎样预约	询问增值服务内容
终末期肾病赔吗	某种疾病是否在承保范围内
身故保险金的责任免除	保障项目的责任免除详情
职场女性乳腺癌几率	other
严重心肌病怎么赔	得了某个疾病怎样申请理赔
未成年人可以购买尊享惠康吗	投保人条件限制
银保通出单还有限额吗	other
您这边可以帮我办理保单回溯吗？	保单回溯
减额交清有什么影响?	减额缴清的影响
同业产品比较	询问产品优势
年交和月交有什么区别	询问缴费年期 询问区别
海外二次诊疗？	释义项的定义
为他人投保	询问投保规则
申请理赔需要提供什么材料呢	保障项目如何申请理赔
职业分类怎么看	投保的职业要求
你多大？	other
大概要花多少钱呢	保费核算
20岁男30万保额	推荐保额
A重大疾病保险战争干什么用的	释义项的定义
重症骨髓增生异常综合征保不保	某种疾病是否在承保范围内 某种疾病是否在承保范围内
治疗I型糖尿病及其并发症在全国哪家医院最好	询问合作医院
索赔时限和要求	理赔速度
寰宇卡金卡与银卡区别	询问区别
惠康升级能附加住院医疗险吗？	询问附加险
那做一次解释吧	other
电话医生的号码	询问联系方式
恶性肿瘤非危及生命的极早期的恶性病变干什么用的	疾病的定义
能介绍一下你们的产品吗？	询问公司有哪些产品
1型糖尿病患者还可以投保吗	患某疾病是否可以投保 某种疾病是否在承保范围内
子宫肌瘤保不？	某种疾病是否在承保范围内 某种疾病是否在承保范围内
重大器官移植术或造血干细胞移植术什么事	释义项的定义
有没有合同的	询问合同种类
海外医院要求	国外医院的要求
重疾险恶性肿瘤等待期什么是	询问等待期
40种轻症有哪些	疾病种类包含哪些疾病
保单贷款利息多少	询问保单借款
在你们公司的重疾包括哪些	疾病种类包含哪些疾病
犹豫期期间可以做什么	询问犹豫期
身故免责提款	询问免责条款
50万保额  20年年交	询问缴费年期
恶性肿瘤哪些算是	疾病的定义
尊享惠康主要是保什么的	询问保险责任
2018绿医通道亮点新增服务内容	询问增值服务内容
身故保不保？	某种情景是否可以投保
理赔医院	理赔医院
基因检测项目有哪些	询问增值服务内容
脑损伤在不在保障范围\r内<div>\n</div>	某种疾病的保障范围
可以取消保费自动垫交吗	询问保费垫缴
深圳医院。	询问合作医院
轻症疾病	疾病种类的定义
中度肌营养不良症赔吗	某种疾病是否在承保范围内
取消保险费自动垫缴功能	询问保费垫缴
甲状腺肿瘤在不在保障范围?	某种疾病的保障范围
购买附加险有什么要求	询问附加险
不测算了	other
专家手术绿通\r<div>\n</div>	询问增值服务内容
基因检测怎么使用	询问增值服务内容
阿尔茨海默病在不在保障范围内	某种疾病的保障范围
保单借款是什么	询问保单借款
得了轻症怎么赔付呢？	疾病种类的赔付流程
有没有不享受该减额缴清保险利益的情况	other
重疾险A重大疾病保险这个保险的受益人有哪些呢	询问受益人
A重大疾病保险的重大疾病保险金是多少	保障项目的定义
你的妈妈是谁啊	other
前列腺癌赔吗	某种疾病是否在承保范围内
合作医院有哪些？	询问合作医院
心脏病能保马	某种疾病是否在承保范围内
海外二诊意见	释义项的定义
甲状腺肿瘤是重症还是轻症	某疾病是否属于某疾病种类
流感保不保	某种疾病是否在承保范围内
严重慢性缩窄性心包炎怎么赔	得了某个疾病怎样申请理赔
重疾险减额缴清含义	询问减额缴清
惠康怎么升级为尊享惠康	产品升级介绍
重疾险合同恢复是啥	询问合同恢复
复效期是怎样的	询问复效期
健康告知曾经患有甲状腺疾病能投保吗	询问如实告知 患某疾病是否可以投保
三度烧伤	释义项的定义
惠康。	产品介绍
我能干什么	other
腹痛可以投保吗	患某疾病是否可以投保
月缴费？	询问缴费年期
发现有精神分裂症能投保吗？	患某疾病是否可以投保
电话医生的电话号码是多少？	询问联系方式
帮我测算一下吧	保费核算
会员等级	询问增值服务内容
有什么保险推荐呢	产品推荐
健康告知女性乳腺纤维瘤	询问如实告知
老年人投保规则具体是什么	询问投保规则
新发现有胸痛	other
你们的检测机构权威吗	other
癌症可以买尊享惠康吗	患某疾病是否可以投保
哈哈哈	other
运动功能损害	释义项的定义
治疗费用&nbsp;艾滋病	疾病治疗费用
重大疾病保险金是啥	保障项目的定义
重疾绿通怎么使用	询问增值服务内容
什么是*深度昏迷	疾病的定义
13582733508	other
我不要这份单	询问合同解除
保额要求	产品保额限制
未成年人最高可以投保多少保额，需要体检吗？	体检指引 产品保额限制
严重阿尔茨\r海默病	疾病的定义
心血管疾病排名第一的	询问合作医院
甲状腺疾病健康告知	询问如实告知
全残的免责条款有哪些	询问免责条款
健康告知患有尿毒症能投保吗	患某疾病是否可以投保
你好，请问我先测试下保费需要多少钱？	保费核算
我要是得了癌症赔不赔	某种疾病是否在承保范围内
健康告知女性有子宫内膜异位症能通过核保吗	询问如实告知
肠癌或高发肿瘤基因检测在等待期查出会不会	询问等待期
真想惠康的保险责任。	询问保险责任
国内2诊	询问增值服务内容
购买的保单有没有份额限制？	产品保额限制
尊享惠康产品条款	询问保险条款
脑垂体瘤、脑囊肿、脑血管瘤	疾病的定义
手机投保的步骤	投保途径
重疾险有必要买了。	other
肾炎健康告知	询问如实告知
重疾险合同恢复恶性肿瘤定义	释义项的定义
保险人车祸死亡会赔吗	某情景下全残或身故赔偿
还有其他增值服务嘛？	询问增值服务项目
重大疾病保险金恶性肿瘤是否赔偿	某种疾病是否在承保范围内
未归还款项的偿还如何处理	询问未归还款项偿还
海外二次诊疗意见是什么	释义项的定义
投保健康不用填写投保风险偏好测试问卷吧	询问投保书填写
绿医通道这个公司的公司地址在哪里	询问增值服务内容 公司地址
怀孕了可以投保吗	某种情景是否可以投保
A重大疾病保险重大疾病保险金重疾险投保人是谁	询问投保人
永久不可逆是怎么解释？	释义项的定义
60周岁以上的可以作为投保人吗？	询问投保年龄
先天性畸形、变形或染色体异常	疾病的定义
健康告知曾经感染艾滋病病毒能投保吗	某种情景是否可以投保
3，重大疾病绿色通道是什么	询问增值服务内容
重大疾病绿色就医通道？	询问增值服务内容
有什么重要权益	other
重大疾病保险金A重大疾病保险重疾险AB赔付谁低	保障项目的理赔方式
体检保额是多少	体检指引
投保的年龄？	询问投保年龄
专业导医陪诊.	询问增值服务内容
电话认证：13792073735	other
因器官移植导致的人类免疫缺陷病毒感染理赔条件	理赔条件
介绍一下你们公司。	询问公司介绍
重大疾病责任保额是什么意思	释义项的定义
渣打银行	other
慢性淋巴细胞白血病赔吗	某种疾病是否在承保范围内
国内治疗冠心病哪家医院好	询问合作医院
被保险人是未成年人，能买保额100万吗	产品保额限制
轻症豁免的费用也是一年一年缴吗？	询问缴费方式
国内严重胃肠炎最好的医院	询问合作医院
健康告知癫痫	询问如实告知
有艾滋病能投保吗	某种情景是否可以投保
重大疾病保险金A重大疾病保险重疾险这个保险的保险期限是多少	询问保险期间
提交理赔材料，医院证明有什么要求	理赔医院
脑血栓怎么赔付？	某种疾病是否在承保范围内
轻疾险呢？	保险种类的定义
咱想换成这款产品有什么优势呢？	询问产品优势
绿通包括什么	询问保险责任
心脏支架是属于重症还是轻症	某疾病是否属于某疾病种类
13832793927	other
感冒赔不赔\n	某种疾病是否在承保范围内 某种疾病是否在承保范围内
重大疾病保险金借款不还会终止合同吗	询问合同终止
心肌梗塞在不在保障范围	某种疾病的保障范围
轻症豁免的交费方式	询问缴费方式
慢性肾功能衰竭保不保	某种疾病是否在承保范围内 某种疾病是否在承保范围内
重疾险合同恢复战争恶性肿瘤是啥	疾病的定义
理赔需要什么资料	保障项目如何申请理赔
重大疾病保险金合同恢复恶性肿瘤等待期赔偿吗	other
绿色通道的医院	询问合作医院
年纪大，保费也太高了	other
黄哲帅吗？	other
合同恢复减额缴清战争恶性肿瘤非危及生命的极早期的恶性病变什么意思	疾病的定义
有艾滋病	other
什么意思	other
重疾理赔	得了某类疾病怎样申请理赔
有心脏病	疾病的定义
重大疾病保险金重疾险A重大疾病保险我如果死了赔偿金给谁	询问宣告死亡 询问保险金给付
得了轻症，豁免保费了之后，保单还有现金价值吗？	豁免保费后保单是否存在现金价值
1型糖尿病并发肾病是什么	疾病的定义
专科医院	询问合作医院
电话验证十13711444561	other
急性或亚急性重症肝炎赔不赔	某种疾病是否在承保范围内 某种疾病是否在承保范围内
内窥镜	释义项的定义
导医陪诊服务	询问增值服务内容
手机银行能买多少	投保途径
投保后受益人死亡了怎么办	询问受益人
尊享惠康可以保费垫交吗	询问保费垫缴
恶性肿瘤非危及生命的极早期的恶性病变等待期什么是	询问等待期
良性肿瘤保障范围	某种疾病的保障范围
开门红？	other
身体健康怎么解释	释义项的定义
我是女的	other
减额缴清如何处理减额缴清	询问减额缴清
你们公司是做什么的？	询问公司介绍
严重弥漫性系统性硬皮病怎么赔	得了某个疾病怎样申请理赔
我38岁，有什么保险推荐吗	产品推荐
体检的标准	体检标准
腺体瘤	疾病的定义
重疾险减额缴清战争恶性肿瘤等待期不知道是啥	疾病的定义
中级需要体检吗？	询问体检或验尸
轻微脑中风\r<div>\n</div>	疾病的定义
购买尊享惠康可以最高投保多少	产品保额限制
多少岁了	other
请介绍一下这个保险	产品介绍
90种重疾有哪些啊	疾病种类包含哪些疾病
尊享礼遇	询问增值服务内容
心脏支架是轻症还是重疾?	某疾病是否属于某疾病种类
尊享惠康的优势有哪些？	询问产品优势
理赔了生命关爱金后，有幸活过6个月，怎么理赔呢	保障项目的理赔方式
你们有什么产品推荐。	产品推荐
保险合同的够差鞥	询问合同种类
重大疾病保险金合同恢复恶性肿瘤等待期会赔吗	询问等待期
投保年龄是？	询问投保年龄
轻症是怎么赔的呢	得了某类疾病怎样申请理赔
艾滋病赔不赔	某种疾病是否在承保范围内
*严重帕金森病是什么	疾病的定义
介绍一下产品好吗	询问公司有哪些产品
癌症关爱金赔付多少	询问赔付比例
异地就医补贴最高省内2000元是一次的还是累计的	疾病的定义
重大疾病保险金恢复合同需要什么	询问合同恢复
重疾险A重大疾病保险重大疾病保险金减额缴清战争恶性肿瘤非危及生命的极早期的恶性病变恶性肿瘤定义	other
基因检测要求	询问增值服务内容
重疾险A重大疾病保险重大疾病保险金合同恢复战争恶性肿瘤非危及生命的极早期的恶性病变恶性肿瘤干什么用的	other
高发疾病主要有那几类	疾病种类包含哪些疾病
开门红绿色就医通道？	询问增值服务内容
重大疾病保险金合同恢复减额缴清战争恶性肿瘤非危及生命的极早期的恶性病变恶性肿瘤等待期干什么用的	other
重大疾病保险金重疾险A重大疾病保险受益人可以更改吗	变更受益人相关规定
有再生障碍性贫血	疾病的定义
重疾险A重大疾病保险战争含义	释义项的定义
未成年投保的最高保额	产品保额限制
重大疾病保险金战争恶性肿瘤非危及生命的极早期的恶性病变恶性肿瘤定义	疾病的定义
上海	other
如何获得重大疾病绿色就医通道服务	询问增值服务内容
重大疾病保险金合同恢复战争恶性肿瘤非危及生命的极早期的恶性病变有什么用	other
电话验证13478886721	other
再测一次。	other
所有增值服务是不是随保单的有效而有效	询问增值服务项目
电话验证：15914343651	other
小病保不保（感冒发烧保不保）	某种疾病是否在承保范围内
减额缴清恶性肿瘤什么是	询问减额缴清 疾病的定义
绿医通道需要支付挂号费吗？	询问增值服务内容
重疾险A重大疾病保险重大疾病保险金合同恢复减额缴清不知道是啥	询问减额缴清
重疾险A重大疾病保险合同恢复减额缴清战争等待期什么意思	询问等待期
最近有什么健康方面的产品呢？	询问公司有哪些产品
国内二诊	询问增值服务内容
你是人工吗	other
专业导医赔诊？	询问增值服务内容
癌症理赔资料	得了某个疾病怎样申请理赔 理赔需要的材料
重疾险A重大疾病保险合同恢复减额缴清等待期干什么用的	询问等待期
合同恢复减额缴清等待期哪些算是	other
产品有哪些主要特色？	询问产品优势
心脏病属于什么科目	疾病的定义
买保险注意事项	询问保险责任
重疾险减额缴清战争恶性肿瘤非危及生命的极早期的恶性病变什么意思	other
寰宇卡可以使用几次？	询问增值服务内容
重大疾病保险金有没有不赔偿的情况呢	保障项目的责任免除详情
惠康的切入话术	释义项的定义
康爱宝	产品介绍
我要申请理赔不知道流程	得了某类疾病怎样申请理赔
人身险危险保额的意义	释义项的定义
有什么银行可以用APP购买保险	询问保险责任
可以期缴吗	询问缴费年期
其他	other
电话验证＋13931149703	other
尊享惠康有什么保障	询问保险责任
医疗	释义项的定义
13825716762	other
尊享惠康的保障范围是哪些	询问保险责任
重大疾病保险金战争是否赔偿	情景是否赔偿某个保障项目
有吸烟和喝酒习惯会不会被加费？	投保指引
费率是全国统一的么	other
电话验证+13811064406	other
矫正视力低于	other
重型再生障碍性贫血理赔条件	理赔条件
A重大疾病保险合同恢复战争恶性肿瘤非危及生命的极早期的恶性病变什么意思	other
得了轻症，豁免保费了之后，还可以保单贷款吗？	询问保单借款
电话验证+18507718416	other
保额是怎么计算的？	询问保额
未成年身故如何理赔	特殊人群的理赔方式 某情景下全残或身故赔偿
等待期发生意外导致恶性肿瘤能否赔偿	某种疾病是否在承保范围内
聋哑投保健康告知	询问如实告知
嗯	other
重疾险合同恢复等待期有什么用	询问等待期
重疾的种类/	疾病种类的定义
惠康条款	询问保险条款
康无忧	产品介绍
甲状腺保不保	某种疾病是否在承保范围内
高发肿瘤基因检测如何申请使用	询问增值服务内容
保单回溯有什么要求	保单回溯
合同恢复减额缴清战争恶性肿瘤是多少	询问减额缴清
重大疾病保险金如何终止合同	询问合同终止
等待期意外导致的感冒赔不赔？	某种疾病是否在承保范围内
*双耳失聪	疾病的定义
肿瘤基因检测	询问增值服务内容
身体残障者投保手术津贴险种	询问保险种类
体检表有吗	询问体检或验尸
可以附加康无忧吗	询问附加险
优惠	购买某项保险产品有无优惠
全程导医服务的使用次数	增值服务使用次数
轻症豁免的费用是一年交的吗	询问缴费方式
什么是重疾险？	保障项目的定义
理赔申请	保障项目如何申请理赔
在线问诊	询问增值服务内容
我要交多少钱？	保费核算
健康告知有腹痛能通过核保吗	询问如实告知
重大疾病赔多少次	保障项目的赔付次数
颈动脉血管成形术或内膜切除术是什么	释义项的定义
近六个月内有不明原因出血能投保吗	某种情景是否可以投保
惠康升级尊享惠康\n	产品升级介绍
被保险人死了钱给谁	询问受益人
轻症和重疾如何定义	疾病种类的定义
健康告知不明原因出血点	询问如实告知
重疾绿通有在居住地有专车接送？	询问增值服务内容
中度类风湿性关节炎理赔条件	理赔条件
轻症疾病病种	疾病种类的定义
国内&nbsp;二诊意见	释义项的定义
电话医生是什么啊？	询问增值服务内容
为什么要验尸	询问体检或验尸
北京合作医院	询问合作医院
身故保险金谁赔付多	询问赔付比例
非阿尔茨海默病所致严重痴呆	疾病的定义
儿科	释义项的定义
如果需要体检，体检费用是由谁出	体检指引
你的爸爸是谁啊	other
智能障碍者投保	特殊人群投保规则
产品优势	询问产品优势
高发肿瘤基因检测是在那里检查呢?	询问增值服务内容
保险费垫缴是可选的利益吗	询问保费垫缴
亮点	询问产品优势
怎么申请专家住院绿通	询问增值服务内容
多发性硬化病	疾病的定义
健康告知有身体不适	询问如实告知
2，\t有哪些高发疾病	高发疾病
国内重疾绿通怎么用	询问增值服务内容
健康告知有饮酒习惯	询问如实告知
耳科医院	询问合作医院
心脏病可以保吗	患某疾病是否可以投保
体检项目是哪些	某项体检的包含项
小雨伞和小棉袄这两款保险？	产品介绍
客户半个身子不能动	情景的定义
公司实力如何呢	公司经营状况
有红斑狼疮能投保吗	患某疾病是否可以投保
白血病保吗?	某种疾病是否在承保范围内
拜拜	other
小孩和老人可以投保吗	询问投保年龄
溃疡性结肠炎	疾病的定义
国外理赔保额会变化吗	询问保额规定
健康告知有多发性硬化病核保能通过吗	询问如实告知
重大疾病保险金合同恢复等待期定义	询问等待期
尊享惠康的复效期多长时间？	询问复效期
手机投保月缴首期投保缴两个月的保费吗	投保渠道的月缴首期
附加意外住院医疗	询问附加险
血压150需要加费	other
举重健康告知	询问如实告知
怀孕期能投保吗	某种情景是否可以投保
等待期内意外导致的脑瘤赔不赔	询问等待期 某种疾病是否在承保范围内
经输血导致的人类免疫缺陷病毒感染	疾病的定义
腔静脉过滤器植入术理赔条件	理赔条件
绿通的使用期限	增值服务使用时间
深圳天气如何	other
等待期有多长时间	询问等待期
早产儿保马	患某疾病是否可以投保
a保险和b保险有啥区别呢	询问区别
冠状动脉搭桥手术	释义项的定义
合同恢复战争不知道是啥	释义项的定义
全国客服热线上班时间：	咨询时间
重大疾病保险金减额缴清办理后会怎么样	询问减额缴清
威信平台绑定使用服务流程	某渠道的投保流程
恶性肿瘤怎么解释	疾病的定义
能跟我介绍一下尊享惠康吗	产品介绍
国内二诊意见是可以用两次吗	增值服务使用次数
健康告知有参加潜水活动	询问如实告知
购买有地区限制吗？	产品保障的地域限制
胆道重建手术是什么	释义项的定义
尊享惠康保障多久	产品保障期限
尊享惠康的重疾	疾病种类的定义
语言能力丧失可以陪吗	患某疾病是否可以投保
患了重疾怎么理赔/	得了某类疾病怎样申请理赔
在手机上投保可以有纸质版的合同么?	申请纸质合同
人身险危险保额的意思	释义项的定义
会不会破产	公司经营状况
健康告知儿童有脑瘫核保能通过吗	询问如实告知
患有甲状腺结节可以投保吗	患某疾病是否可以投保
严重癫痫怎么赔	某种疾病是否在承保范围内
双侧卵巢切除保不保	某种情景是否可以投保
怎么获得基因检测/	询问增值服务内容
投保人和被保险人	投保人与被保险人关系
有好的分科医院推荐吗	询问合作医院
什么事等待期？	询问等待期
减额缴清恶性肿瘤是啥	询问减额缴清
哪个手机	other
重大疾病保险金合同恢复失败了	询问合同恢复
投保人和被保险人要有亲属关系吗	投保人与被保险人关系
癌症特别关爱金除外责任	保障项目的责任免除详情
现金价值除了借款，还有其他用途吗	询问现金价值
重大疾病保障范围	询问保险责任
可以更改受益人慢慢	变更受益人相关规定
植物人状态的定义	疾病的定义
国内买的保险移民去国外了还有的赔吗？	理赔的地域限制
失踪后又出现合同怎么办	询问失踪处理
保单中止	询问合同解除
什么是多发性骨髓瘤	疾病的定义
重疾险哪些算是	疾病种类包含哪些疾病
轻症是如何赔付的	疾病种类的赔付流程
健康告知有瘫痪保能通过吗	询问如实告知
骨髓造血干细胞的异体移植手术	释义项的定义
攀岩我不懂是什么意思	情景的定义
肺炎	疾病的定义
肺炎属于轻症吗	某疾病是否属于某疾病种类
能分别简单介绍一下个保险金吗	    产品介绍
你好我想了解如何预约那个医院的医生啊！	询问合作医院
脑中风	疾病的定义
肺部严重损害	释义项的定义
在哪里可以投保？	投保途径
保费豁免	释义项的定义
基因检测预约方式	询问增值服务内容
患有高血压投保健康告知	询问如实告知
去年已获得过绿色就医通道，可以同步升级吗？	产品升级介绍
如果没有指定收益人，要怎么进行分配	询问受益人
重大疾病保险金什么时候合同效力恢复	询问复效期
中止期后重新缴费需要体检吗	询问体检或验尸
终身保障比定期保障好在哪里？	询问区别
重疾保障包括白血病吗	某种疾病的保障范围
A重大疾病保险减额缴清什么是	询问减额缴清
不典型心肌梗塞是什么	疾病的定义
合同生效日期	询问合同生效
产品的亮点有哪些？	询问产品优势
嗯行吧！	other
重大疾病保险金保费能否不用人民币	询问投保规则
I型糖尿病是什么	疾病的定义
慢性肺源性心脏病是什么	疾病的定义
手机上投保有什么要求	投保途径 询问投保规则
轻疾包括哪些	疾病种类包含哪些疾病
重症豁免的定义	释义项的定义
保险有什么用	产品介绍
发现有脑中风能投保吗？	患某疾病是否可以投保
肺叶切除术，在保险范围吗	某种疾病的保障范围 某种疾病是否在承保范围内
那轻症呢	疾病种类的定义
我该如何支付	保费支付渠道
体检保额有什么规定	询问保额规定
癌症是不是保障范围	某种疾病是否在承保范围内 某种疾病的保障范围 某种疾病是否在承保范围内
能帮我测算保费吗	保费核算
成为会员有什么好处	询问增值服务内容
10年期有什么服务	询问某产品增值服务项目
嗜铬细胞瘤怎么赔	某种疾病是否在承保范围内 某种疾病是否在承保范围内
健康告知参加赛马活动	询问如实告知
保单借款利率是怎么样的？	询问保单借款 查询方式
重疾险合同恢复战争等待期定义	询问等待期
参加赛马活动投保健康告知	询问如实告知
等待期什么时候开始算起	询问等待期
重疾险A重大疾病保险重大疾病保险金合同恢复是什么	询问合同恢复
重疾险A重大疾病保险合同恢复什么是	询问合同恢复
意外赔不赔	情景是否赔偿某个保障项目
康无忧的内容	产品介绍
全残的免责条款有哪些？	保障免除项目的责任免除详情
重大疾病保险金A重大疾病保险不太明白什么是受益人	询问受益人
理赔食宿	理赔速度
轻度烧伤	疾病的定义
轻症是怎么赔、	疾病种类的赔付流程
我在广州绿衣有合作医院吗	询问合作医院
重疾险减额缴清什么意思	询问减额缴清
健康告知有智能障碍核保能通过吗	询问如实告知
全身型重症肌无力赔不赔	某种疾病是否在承保范围内 某种疾病是否在承保范围内
尊享惠康不保什么	保障免除项目的责任免除详情
高血压能投保吗？	患某疾病是否可以投保
军人证没有确切的出生日期，是按当年周岁吗	other
最高投保金额	产品保额限制
尊享惠康的保险责任有哪四项？	询问保险责任
严重慢性复发性胰腺炎	疾病的定义
我奶奶可以投保吗	询问投保年龄
重大疾病保险金减额缴清含义	询问减额缴清
电话医生能用多少次	增值服务使用次数
重疾险重大疾病保险金解释一下	保障项目的定义
儿童抽搐健康告知	询问如实告知
附加意外伤害保险	询问附加险
重疾和轻症的区别	区分疾病种类的标准
减额缴清减额缴清怎么弄	询问减额缴清
安徽分公司联系方式		询问分公司联系方式
国内买的保险在国外就医了如何进行理赔		理赔的地域限制
国外理陪的流程		理赔的地域限制
国外理陪流程是怎么样		理赔的地域限制
在干嘛		other
在线医生		询问增值服务内容
健康测评是做什么的		询问增值服务内容
在线问诊时间是什么时候		询问增值服务内容
在线问诊操作		询问增值服务内容
健康测评在哪里		询问增值服务内容
建康测试		询问增值服务内容
去哪里在线问诊		询问增值服务内容
肠癌检测怎么操作		询问增值服务内容
高发肿瘤基因检测		询问增值服务内容
基因检测如何操作		询问增值服务内容
基因检测地点		询问增值服务内容
基因怎么检测		询问增值服务内容
高发肿瘤基因检测去哪里使用		询问增值服务内容
基因检测怎么做		询问增值服务内容
境外体检		询问增值服务内容
天津分公司地址		公司地址
这个计划怎么参加的		投保指引
标准的购买方式		投保指引
这款产品我要在哪里买呀		投保指引
去哪里买呢		投保指引
手机投保		投保途径
哪里可以购买尊享惠康		投保指引
如何购买		投保指引
你们的产品哪里值得购买		询问产品优势
安徽合作医院		询问合作医院
如何申请终止续期保费自动转账		询问保险费缴纳
如何取消续期保费自动转账		询问保险费缴纳
合伙骗人		other
重疾绿通合作医院		询问合作医院 询问增值服务内容
哪些医院		询问合作医院
合同找不到		合同丢失
吉林合作医院		询问合作医院
中信的员工购买会有优惠吗		某人购买产品是否有优惠
信诚的员工购买会有优惠吗		某人购买产品是否有优惠
售后服务		服务内容介绍
有专人服务吗		服务内容介绍
售后方便吗		服务内容介绍
签合同有无经办人的		服务内容介绍
有人工吗		服务内容介绍
售后联系		询问增值服务内容
四川合作医院		询问合作医院
国内内分泌最好的医院		询问合作医院
内分泌		other
国内内分泌排名第一的医院		询问合作医院
国内小儿内科排名第一的医院		询问合作医院
国内康复医学排名第一的医院		询问合作医院
国内心外科最好的医院		询问合作医院
国内放射科排名第一的医院		询问合作医院
国内泌尿外科最好的医院		询问合作医院
国内泌尿外科排名第一的医院		询问合作医院
国内烧伤科最好的医院		询问合作医院
国内病理科最好的医院		询问合作医院
国内皮肤科排名第一的医院		询问合作医院
国内眼科最好的医院		询问合作医院
眼科去哪看最好		询问合作医院
国内神经内科排名第一的医院		询问合作医院
国内肾脏病最好的医院		询问合作医院
恶性肿瘤治愈率排名第一的医院是什么		询问合作医院
国内胸外科排名第一的医院		询问合作医院
国内超声医学排名第一的医院		询问合作医院
国内风湿科排名第一的医院		询问合作医院
国内骨科排名第一的医院		询问合作医院
国外理赔医院		理赔的地域限制 国外医院的要求
国外可以理赔吗		理赔的地域限制
在国外可以买吗		理赔的地域限制
参保之后公司倒闭了谁来赔		公司经营状况
健康告知有多发性硬化病能通过核保吗		询问如实告知
健康告知有发热能通过核保吗		询问如实告知
健康告知有心悸能通过核保吗		询问如实告知
健康状况有要求吗		投保规则
身体健康才能参加吗		投保规则
公司的偿付能力如何		公司经营状况
心脏病患者能投保吗		患某疾病是否可以投保
怎么获得导医服务		询问增值服务内容
全程导医服务		询问增值服务内容
内蒙合作医院		询问合作医院
有投连险吗		险种推荐
取消自动转账后还在划扣保费		other
取消自动扣费后要怎么重新授权扣费		other
北京分公司电话		询问联系方式
保单借款利率多少		询问保单借款
投保人条件		投保人条件限制
了解一下投保规则		询问投保规则
什么情况下信托合同自动终止		合同自动终止的情景
解释一下保险		释义项的定义
重疾险的定义是什么		险种介绍
那什么是重疾险呢		险种介绍
怎么成为尊崇会员		询问增值服务内容
会员有分级吗		询问增值服务内容
会员卡分级		询问增值服务内容
可以介绍一下你们公司的会员等级和要求吗		询问增值服务内容
投保需要体检时体检的费用是自己出吗		询问体检或验尸
公司地址		公司地址
怎么联系分公司		询问分公司联系方式
检测结果准确吗		other
保单周年日		释义项的定义
这份保险我怎么知道是真的		保单查询
三甲医院绿色通道		询问增值服务内容
上海机构		other
专业导医陪诊是什么服务		询问增值服务内容
专家住院绿通是什么服务		询问增值服务内容
专车接送		询问增值服务内容
介绍一下你们公司		询问公司介绍
公司简介		询问公司介绍
企业简介		询问公司介绍
信诚简介		询问公司介绍
可以简单的介绍一下公司吗		询问公司介绍
公司介绍有吗		询问公司介绍
乳腺结节是否可以投保		患某疾病是否可以投保
乳腺超声检查是什么		询问增值服务内容
电话多少		询问联系方式
有没有电话		询问联系方式
云南绿通		询问增值服务内容
云南合作医院		询问合作医院
电话医生的电话号码	询问联系方式
真想惠康是什么？	产品介绍
投保人还是被保人可以申请使用绿通	询问增值服务内容
老款惠康现在还可以升级吗	产品升级介绍
金雪球56岁可能买	询问投保年龄
孕妇	释义项的定义
未成年人投保重疾险的限额是多少	特殊人群投保规则
能对比平安的一生保马	保险产品的对比
寰宇卡有效期	询问增值服务内容
听到后面是一年交的吗？	询问缴费年期
报销	other
眼科？	询问合作医院
重要权益	other
儿童特定疾病	疾病种类的定义
死亡怎么赔付	询问宣告死亡
什么是人类疯牛病	疾病的定义
在线问诊的次数	询问增值服务内容
赔款会不会很慢	询问合同终止
失去一肢及一眼怎么赔	某种疾病是否在承保范围内
合同恢复减额缴清战争恶性肿瘤等待期有什么用	询问等待期
申领重大疾病保险金、轻症保险金、癌症特别关爱金	保障项目如何申请理赔
如果客户是因为喝了一点酒，但是没有达到醉驾的程度，造成死亡的赔不赔？	某情景下全残或身故赔偿
测算	保费核算
爷爷可以帮孙子购买尊享惠康吗	投保人和被保险人关系
重大疾病都保什么病种/	产品保哪些疾病
对于理赔是如何进行核定的	保障项目如何申请理赔
受益人可以变更吗	询问受益人
重疾绿通？	询问增值服务内容
良性肿瘤可以理赔吗	得了某个疾病怎样申请理赔 某种疾病是否在承保范围内
进行性脊肌萎缩症	疾病的定义
重疾险战争恶性肿瘤等待期什么是	询问等待期
肺功能衰竭在不在保障范围内	某种疾病的保障范围
好的，帮我办理吧	other
我们的重疾险在国外医院确诊后，不回国看病能不能理赔？	保障项目的理赔方式
8周岁	other
尊享惠康有哪些保障？	询问保险责任
机动车商业险是什么	保险种类的定义
白血病重疾保吗	患某疾病是否可以投保
绿医通道	询问增值服务内容
一般体检项目有哪些	询问体检或验尸
那这保险不保什么啊	询问保险责任 保障项目的责任免除详情
现金价值低	询问现金价值
辽宁	other
会不会跟其他保险冲突	other
投保人与被保险人关系	投保人与被保险人关系
我在广州，你们有合作医院吗	询问合作医院
尊享惠康是什么特色服务	询问某产品增值服务项目
重大疾病保险金减额缴清后还要再缴保险费吗	询问减额缴清
投保的规则是什么	询问投保规则
如何购买尊亨惠康	投保指引
Ⅱ级重症急性胰腺炎怎么赔	得了某个疾病怎样申请理赔
近两年有住院过能买吗	某种情景是否可以投保
重疾险合同恢复解释一下	询问合同恢复
惠康保障内容	询问保险责任
重疾险减额缴清战争等待期不知道是啥	other
重大疾病保险金减额缴清恶性肿瘤非危及生命的极早期的恶性病变恶性肿瘤定义	other
轻症理赔流程	得了某类疾病怎样申请理赔
等待期瘫痪了保险公司赔不赔	某种疾病是否在承保范围内
附效期	询问复效期
皮肤癌在不在保障范围没内	某种疾病的保障范围
重症包括哪些	疾病种类包含哪些疾病
案例	other
胆结石赔不赔?	某种疾病是否在承保范围内
重大疾病保险金减额缴清恶性肿瘤非危及生命的极早期的恶性病变等待期含义	询问等待期
多个肢体缺失的定义	疾病的定义
电话医生服务是什么？	询问增值服务内容
没有如实告知还会保吗	询问如实告知
如何终止合同	询问合同终止
产品优势有什么	询问产品优势
在线问诊有时间限制吗	咨询时间
开门红绿通生效时间	询问等待期
国内二次会诊	询问增值服务内容
轻症豁免的费用也是一年一年缴的吗？	询问缴费方式
轻症的赔付方式是怎么样	得了某类疾病怎样申请理赔
可以保什么	询问保险责任
重大疾病保险金合同恢复有什么用	询问合同恢复
复效期内申请复效合同还需要核保吗	询问复效期
之前在其他公司购买过其他产品，现在买尊享惠康有冲突吗？	other
A重大疾病保险什么是	产品介绍
分科医院推荐	询问合作医院
严重细菌性脑脊髓膜炎	疾病的定义
信诚寰宇卡是什么	询问增值服务内容
严重多发性硬化症的定义	疾病的定义
买保险的价格和性别有关系吗	other
赛车健康告知	询问如实告知
什么叫不典型心肌梗塞	疾病的定义
客户经理负责人	other
继发性肺动脉高压	疾病的定义
什么是保险	产品介绍
神经系统疾病	疾病的定义
爷爷可以帮自己的孙子进行投保吗	投保人和被保险人关系
四肢畸形投保健康告知	询问如实告知
体检	询问体检或验尸
理赔了生命关爱金后，有幸活过了6个月，那之后怎么办？怎么理赔呢？	保障项目的理赔方式
寰宇卡国际救援可以垫付吗？	询问增值服务内容
小孩不足1周岁患病怎么赔付	特殊人群的理赔方式
骨生长不全症赔不赔	某种疾病是否在承保范围内 某种疾病是否在承保范围内
轻症赔付影不影响保额	疾病种类的赔付流程
绿通怎么申请使用/	询问增值服务内容
脑中风在不在保障范围内	某种疾病的保障范围
等待期有什么用	询问等待期
发生了争议与当事人协商未能解决	询问争议处理
五十岁。	other
中风	疾病的定义
小孩不足2周岁患病怎么赔付	某情景是否在承保范围内
重大器官移植赔吗	某情景是否在承保范围内
心脏病在保障范围吗	某种疾病的保障范围
冠心病或严重冠心病？	疾病的定义
意外身故，怎么赔付	某情景下全残或身故赔偿
绿通对象	询问增值服务内容
保单借款可以吗/	询问保单借款
绿通是给被保险人使用的还是给保险人使用？	询问增值服务内容
诉讼要求	询问诉讼时效
孕妇能不能投保	投保人条件限制
患了轻症要怎么赔？	疾病种类的赔付流程
国内骨癌排名第一的医院	询问合作医院
赔偿要哪些材料	理赔需要的材料
可以带病投保么	某种情景是否可以投保
有高血压可以投保吗	患某疾病是否可以投保
新发现有身体不适症状	other
重大疾病保险金投保有年龄限制吗	询问投保年龄
健康告知有癌前病变核保能通过吗	询问如实告知
国内排名第一的肿瘤医院	询问合作医院
未成年人如何购买	投保指引
急性心肌梗赛	疾病的定义
亲证可以欺负几次。	other
申领重大疾病保险金	保障项目如何申请理赔
心脏支架可以赔付吗	某种疾病是否在承保范围内
未成年人投保	特殊人群投保规则
健康告知有紫斑能通过核保吗	询问如实告知
重疾险A重大疾病保险减额缴清什么意思	询问减额缴清
济南最好的医院是哪家。	询问合作医院
急性心肌梗塞保吗？	某种疾病是否在承保范围内
重疾险A重大疾病保险战争等待期什么意思	询问等待期
健康告知曾经患有糖尿病	询问如实告知
保额选择	产品保额限制
专家门诊绿通是什么	询问增值服务内容
体检时限有无要求	体检的时限要求
专车接送服务获取条件	询问增值服务内容
A重大疾病保险等待期是什么	询问等待期
投保要求和事项有吗	询问投保规则
什么是等待期?	询问等待期
通知保险公司	询问保险事故通知
必尿科最好的医院是哪一。	询问合作医院
你都没回答我的问题	other
无效驾驶证	释义项的定义
健康告知曾经患有哮喘能投保吗	询问如实告知
呼呼。	other
什么叫身体健康	释义项的定义
严重运动神经元病的临床症状	疾病的定义
人寿免责条款	询问免责条款
惠康可以升级成尊享惠康/	产品升级介绍
保险金类型	other
微信咨询服务时间	咨询时间
尊尚	产品介绍
近期有住院记录能投保吗	某种情景是否可以投保
轻症的保障范围	询问保险责任
公司地址	公司地址
在国内购买过保单之后去了国外还能得到理赔吗？	理赔的地域限制
在线问诊的使用时间是什么时间段/	增值服务使用时间
广州市妇科最好的医院	询问合作医院
附加险有哪些	询问附加险
90种重疾种类	疾病种类包含哪些疾病
重大疾病保险金合同恢复恶性肿瘤非危及生命的极早期的恶性病变等待期是什么	询问等待期
重大疾病保险金\n	保障项目的定义
重大疾病保险金都保啥	保障项目保哪些疾病
免责条款有什么	询问免责条款
疾病身故或全残有无等待期的要求	询问等待期
A重大疾病保险保险期间是多少	询问保险期间
重疾险合同恢复减额缴清定义	询问减额缴清
女性有子宫肌瘤能投保吗	患某疾病是否可以投保
遗传疾病	疾病的定义
被保险人的出生日期如果发生错误	询问信息误告
健康告知五周岁以下儿童有抽搐能通过核保吗	询问如实告知
高发肿瘤基因检测可以给家人使用吗	询问增值服务内容
昏迷怎么赔	得了某个疾病怎样申请理赔
全脑炎在不在保障范围内	某种疾病的保障范围
尊享惠康产品是什么	产品介绍
有哪些重症	疾病种类包含哪些疾病
重疾是怎么赔的呢	得了某类疾病怎样申请理赔
